Fecha;Provincia;test_rapidos_total;test_rapidos_positivos;pcr_total;pcr_positivos;codigo_ine;total_pruebas;total_pruebas_positivas;test_porcentaje;pcr_porcentaje;porcentaje_total;sigla
2020-06-23;León;48281;2694;37121;2631;24089;85402;5325;5.579834717590771;7.087632337490908;6.2352169738413625;LE
2020-06-23;Palencia;25080;831;12781;920;34120;37861;1751;3.313397129186603;7.198184805570769;4.624811811626739;PA
2020-06-23;Salamanca;41221;2952;25841;3006;37274;67062;5958;7.1613983163921295;11.632676753995588;8.884316006083923;SA
2020-06-23;Valladolid;60054;2605;57663;5006;47186;117717;7611;4.337762680254437;8.681476856909978;6.465506256530492;VA
2020-06-23;Castilla y León;334557;19001;208728;19427;99999;543285;38428;5.679450736346871;9.307328197462725;7.073267253835463;CyL
2020-06-24;Burgos;46418;2275;26458;1998;9059;72876;4273;4.901115946400103;7.551591201148991;5.8633843789450575;BU
2020-06-24;Salamanca;41498;2980;26105;3008;37274;67603;5988;7.181068967179141;11.522696801379047;8.857595077141548;SA
2020-06-24;Valladolid;60312;2632;58276;5008;47186;118588;7640;4.36397400185701;8.593589127599698;6.4424731001450395;VA
2020-06-24;Castilla y León;335752;19100;210902;19440;99999;546654;38540;5.688722628606828;9.2175512797413;7.0501633574436475;CyL
2020-06-25;León;48601;2722;37733;2632;24089;86334;5354;5.6007078043661656;6.975326637161105;6.201496513540436;LE
2020-06-25;Salamanca;41730;3002;26510;3010;37274;68240;6012;7.1938653247064455;11.354205960015088;8.81008206330598;SA
2020-06-25;Zamora;32793;1552;10158;633;49275;42951;2185;4.732717348214558;6.2315416420555225;5.087192382016717;ZA
2020-06-26;Ávila;32269;1609;13103;1710;5019;45372;3319;4.986209674920202;13.050446462642142;7.315084192894296;AV
2020-06-26;Burgos;46531;2287;27402;1999;9059;73933;4286;4.915002901291611;7.295087949784687;5.79714065437626;BU
2020-06-26;Palencia;25637;847;13282;925;34120;38919;1772;3.303818699535827;6.964312603523566;4.55304607004291;PA
2020-06-26;Soria;24944;1908;8155;1141;42173;33099;3049;7.6491340602950615;13.991416309012875;9.211758663403728;SO
2020-06-26;Zamora;33071;1556;10278;635;49275;43349;2191;4.70502857488434;6.178244794707141;5.054326512722324;ZA
2020-06-26;Castilla y León;340078;19238;215421;19478;99999;555499;38716;5.6569375260969545;9.041829719479532;6.9695895042115295;CyL
2020-06-27;León;49047;2731;38422;2634;24089;87469;5365;5.56812852977756;6.855447399927125;6.133601618859253;LE
2020-06-27;Salamanca;42307;3013;26890;3011;37274;69197;6024;7.1217529014111145;11.197471178876906;8.705579721664233;SA
2020-06-28;León;49054;2731;38510;2635;24089;87564;5366;5.567333958494721;6.842378602960269;6.128089169064912;LE
2020-06-28;Valladolid;61244;2658;60298;5031;47186;121542;7689;4.340016981255307;8.343560317091777;6.32620822431752;VA
2020-06-28;Zamora;33079;1556;10456;635;49275;43535;2191;4.703890685933674;6.073068094873757;5.032732284368898;ZA
2020-06-29;Ávila;32514;1617;13504;1715;5019;46018;3332;4.973242295626499;12.69994075829384;7.24064496501369;AV
2020-06-29;León;49164;2737;38850;2636;24089;88014;5373;5.567081604426003;6.7850707850707845;6.104710614220465;LE
2020-06-29;Salamanca;42506;3047;27222;3012;37274;69728;6059;7.16839975532866;11.064580119021379;8.689479118861863;SA
2020-06-29;Zamora;33120;1556;10492;635;49275;43612;2191;4.6980676328502415;6.052230270682425;5.023846647711639;ZA
2020-06-30;Ávila;32662;1623;13740;1716;5019;46402;3339;4.969077215112363;12.489082969432316;7.195810525408388;AV
2020-06-30;Segovia;25189;2639;19550;2412;40004;44739;5051;10.47679542657509;12.337595907928389;11.289926015333378;SE
2020-06-30;Valladolid;61756;2709;61402;5035;47186;123158;7744;4.386618304294319;8.200058630012052;6.287857873625749;VA
2020-06-30;Castilla y León;342389;19406;222750;19531;99999;565139;38937;5.667822272327673;8.768125701459034;6.88980940972044;CyL
2020-07-01;Segovia;25240;2643;19802;2417;40004;45042;5060;10.471473851030112;12.205837794162205;11.233959415656498;SE
2020-07-01;Castilla y León;343466;19471;225189;19544;99999;568655;39015;5.668974512761089;8.67893191940992;6.8609262206434485;CyL
2020-07-02;Ávila;32998;1638;13985;1716;5019;46983;3354;4.963937208315655;12.27028959599571;7.138752314667007;AV
2020-07-02;León;49853;2763;39915;2636;24089;89768;5399;5.542294345375404;6.6040335713390945;6.01439265662597;LE
2020-07-02;Salamanca;42991;3087;28143;3017;37274;71134;6104;7.180572678002372;10.720250151014461;8.580987994489274;SA
2020-07-02;Valladolid;62026;2730;62825;5041;47186;124851;7771;4.401380066423758;8.023875845602864;6.224219269369088;VA
2020-07-03;Ávila;33094;1639;14148;1718;5019;47242;3357;4.952559376321992;12.143059089623975;7.105965031116379;AV
2020-07-04;Ávila;33141;1640;14247;1718;5019;47388;3358;4.948553151685224;12.058679020144591;7.0861821558200395;AV
2020-07-04;Palencia;25865;867;14310;935;34120;40175;1802;3.3520201043881697;6.533892382948987;4.485376477909147;PA
2020-07-04;Castilla y León;345314;19589;230438;19572;99999;575752;39161;5.672807937123893;8.493390846995721;6.801713237643986;CyL
2020-07-05;Burgos;46860;2315;29655;2004;9059;76515;4319;4.940247545881348;6.757713707637835;5.644644840880873;BU
2020-07-05;Soria;25587;1932;8903;1154;42173;34490;3086;7.550709344589049;12.961922947321128;8.947521020585677;SO
2020-07-05;Castilla y León;345477;19594;231275;19572;99999;576752;39166;5.671578715804525;8.462652686196087;6.790787028046717;CyL
2020-07-06;Ávila;33315;1645;14516;1718;5019;47831;3363;4.9377157436590124;11.835216313033893;7.031004996759424;AV
2020-07-06;Palencia;25915;869;14567;935;34120;40482;1804;3.3532703067721394;6.418617422942267;4.456301566128156;PA
2020-07-06;Castilla y León;346213;19635;233103;19577;99999;579316;39212;5.6713641602135105;8.398433310596603;6.76867202010647;CyL
2020-07-07;Ávila;33421;1651;14668;1718;5019;48089;3369;4.94000777953981;11.712571584401418;7.005760153049553;AV
2020-07-07;Palencia;25942;874;14724;938;34120;40666;1812;3.369054043635803;6.370551480575931;4.4558107509959175;PA
2020-07-07;Valladolid;62462;2769;65013;5047;47186;127475;7816;4.433095321955749;7.763062772060972;6.131398313394784;VA
2020-07-07;Zamora;33458;1565;11386;637;49275;44844;2202;4.677506127084703;5.594589847180749;4.91035590045491;ZA
2020-07-08;Palencia;25974;876;14886;938;34120;40860;1814;3.372603372603373;6.3012226252855035;4.439549681840431;PA
2020-07-08;Salamanca;43416;3135;29313;3019;37274;72729;6154;7.220840243228303;10.299184662095316;8.461549038210341;SA
2020-07-08;Segovia;25494;2662;20766;2429;40004;46260;5091;10.441672550404018;11.697004719252623;11.005188067444877;SE
2020-07-08;Soria;25797;1936;9225;1162;42173;35022;3098;7.504748614179943;12.59620596205962;8.845868311347154;SO
2020-07-08;Zamora;33485;1565;11503;637;49275;44988;2202;4.673734507988652;5.53768582109015;4.89463857028541;ZA
2020-07-09;Ávila;33678;1657;14910;1721;5019;48588;3378;4.920125898212483;11.542588866532528;6.952333909607312;AV
2020-07-09;Palencia;25987;876;15011;940;34120;40998;1816;3.3709162273444413;6.262074478715609;4.42948436509098;PA
2020-07-09;Salamanca;43524;3142;29632;3019;37274;73156;6161;7.21900560610238;10.188309935205183;8.421728908086829;SA
2020-07-09;Segovia;25531;2666;20883;2429;40004;46414;5095;10.442207512435862;11.631470574151223;10.977291334511138;SE
2020-07-09;Valladolid;62676;2791;66174;5051;47186;128850;7842;4.4530601825260065;7.632907184090429;6.086146682188591;VA
2020-07-09;Castilla y León;348195;19755;239281;19608;99999;587476;39363;5.673544996338259;8.194549504557404;6.700358823168946;CyL
2020-07-10;Ávila;33835;1664;15017;1722;5019;48852;3386;4.917984335747008;11.467004062062996;6.9311389502988625;AV
2020-07-10;Burgos;47031;2321;31457;2010;9059;78488;4331;4.935042844081563;6.389674794163461;5.518040974416472;BU
2020-07-10;Segovia;25553;2667;21069;2430;40004;46622;5097;10.437130669588699;11.533532678342588;10.932606923769894;SE
2020-07-10;Soria;25954;1939;9400;1164;42173;35354;3103;7.470910071665254;12.382978723404255;8.776941788765063;SO
2020-07-10;Valladolid;62809;2808;66547;5053;47186;129356;7861;4.470696874651722;7.593129667753617;6.077027737406846;VA
2020-07-10;Castilla y León;348849;19803;242290;19623;99999;591139;39426;5.676668128617253;8.0989723059144;6.669497360180938;CyL
2020-07-11;Burgos;47033;2321;31990;2011;9059;79023;4332;4.934832989603045;6.28633948108784;5.481948293534793;BU
2020-07-11;León;50496;2810;42498;2648;24089;92994;5458;5.56479721166033;6.230881453244859;5.86919586209863;LE
2020-07-11;Salamanca;43587;3150;30049;3019;37274;73636;6169;7.226925459425976;10.046923358514427;8.377695692324407;SA
2020-07-11;Soria;26057;1946;9502;1167;42173;35559;3113;7.468242698699005;12.281624921069248;8.754464411260159;SO
2020-07-11;Valladolid;62818;2812;66814;5055;47186;129632;7867;4.47642395491738;7.565779627024276;6.068717600592446;VA
2020-07-12;Ávila;34217;1667;15292;1725;5019;49509;3392;4.871847327351901;11.28040805650013;6.851279565331556;AV
2020-07-12;León;50496;2810;42607;2648;24089;93103;5458;5.56479721166033;6.214941206843946;5.862324522303256;LE
2020-07-12;Segovia;25581;2667;21176;2434;40004;46757;5101;10.425706579101677;11.494144314318095;10.909596424064846;SE
2020-07-12;Soria;26082;1947;9566;1168;42173;35648;3115;7.464918334483552;12.209910098264686;8.738218132854577;SO
2020-07-12;Zamora;33585;1567;11742;638;49275;45327;2205;4.665773410748846;5.433486629194345;4.864650208485009;ZA
2020-07-13;León;50559;2812;42829;2649;24089;93388;5461;5.561818865088313;6.185061523733919;5.847646378549706;LE
2020-07-13;Palencia;26030;877;15443;940;34120;41473;1817;3.3691893968497886;6.0869002136890495;4.381163648638873;PA
2020-07-13;Salamanca;43668;3163;30346;3021;37274;74014;6184;7.243290281212787;9.955183549726488;8.355176047774746;SA
2020-07-13;Soria;26118;1950;9639;1177;42173;35757;3127;7.466115322765908;12.210810250025936;8.745140811589339;SO
2020-07-13;Zamora;33600;1568;11901;638;49275;45501;2206;4.666666666666667;5.360894042517436;4.848245093514429;ZA
2020-07-13;Castilla y León;349914;19864;246942;19667;99999;596856;39531;5.676823448047235;7.964218318471544;6.623205597330009;CyL
2020-07-14;Salamanca;43711;3165;30711;3024;37274;74422;6189;7.240740317082657;9.846634756276252;8.31608932842439;SA
2020-07-14;Valladolid;62985;2833;68085;5073;47186;131070;7906;4.497896324521712;7.450980392156863;6.031891355764095;VA
2020-07-14;Zamora;33615;1568;12028;638;49275;45643;2206;4.664584262977837;5.304289990023279;4.833161711543939;ZA
2020-07-15;Ávila;34604;1680;15776;1725;5019;50380;3405;4.854930065888337;10.934330628803245;6.758634378721714;AV
2020-07-15;Palencia;26071;881;15704;943;34120;41775;1824;3.379233631237774;6.004839531329598;4.36624775583483;PA
2020-07-16;Ávila;34746;1681;15849;1725;5019;50595;3406;4.837966960225637;10.883967442740868;6.731890503014132;AV
2020-07-16;Palencia;26093;882;15875;947;34120;41968;1829;3.3802169164143643;5.965354330708662;4.358082348455967;PA
2020-07-16;Segovia;25706;2683;21852;2440;40004;47558;5123;10.437252003423325;11.166025993044116;10.772109844821061;SE
2020-07-16;Zamora;33714;1570;12215;638;49275;45929;2208;4.65681912558581;5.223086369218175;4.807420148490061;ZA
2020-07-17;Burgos;47157;2328;34505;2022;9059;81662;4350;4.936700807939436;5.860020286914939;5.3268350028164875;BU
2020-07-17;Palencia;26109;883;16017;949;34120;42126;1832;3.3819755639817686;5.924954735593432;4.348858187342733;PA
2020-07-17;Zamora;33732;1571;12329;638;49275;46061;2209;4.657298707458793;5.174791142833969;4.795814246325525;ZA
2020-07-18;León;50877;2827;44625;2657;24089;95502;5484;5.556538317903965;5.95406162464986;5.7422881196205315;LE
2020-07-18;Salamanca;43972;3191;31430;3027;37274;75402;6218;7.256890748658237;9.630925867006045;8.24646561099175;SA
2020-07-18;Valladolid;63261;2851;69897;5088;47186;133158;7939;4.506726102970235;7.279282372634019;5.962090148545337;VA
2020-07-19;Ávila;35071;1691;16127;1725;5019;51198;3416;4.821647515040917;10.696347739815216;6.672135630298058;AV
2020-07-19;Burgos;47166;2328;35279;2030;9059;82445;4358;4.935758809311793;5.754131352929505;5.2859482078961735;BU
2020-07-19;León;50879;2827;44719;2662;24089;95598;5489;5.556319896224376;5.952727028779713;5.741751919496224;LE
2020-07-19;Salamanca;43974;3191;31592;3027;37274;75566;6218;7.25656069495611;9.581539630286148;8.228568403779478;SA
2020-07-19;Valladolid;63265;2853;70019;5090;47186;133284;7943;4.509602465818383;7.269455433525186;5.95945499834939;VA
2020-07-19;Zamora;33734;1571;12429;638;49275;46163;2209;4.657022588486394;5.133156327942714;4.785217598509629;ZA
2020-07-19;Castilla y León;352587;20005;258814;19769;99999;611401;39774;5.673776968521245;7.638303955736552;6.505386808330376;CyL
2020-07-20;Palencia;26128;883;16272;950;34120;42400;1833;3.379516227801592;5.838249754178958;4.32311320754717;PA
2020-07-20;Valladolid;63348;2854;70446;5100;47186;133794;7954;4.505272463219044;7.239587769355251;5.944960162638085;VA
2020-07-20;Castilla y León;353166;20027;260420;19797;99999;613586;39824;5.670704427946065;7.601950695031104;6.490369728122872;CyL
2020-07-21;Palencia;26149;885;16401;950;34120;42550;1835;3.3844506482083445;5.792329735991708;4.312573443008225;PA
2020-07-21;Segovia;25862;2695;22481;2445;40004;48343;5140;10.420694455185215;10.875850718384413;10.632356287363217;SE
2020-07-21;Soria;26818;1981;10661;1211;42173;37479;3192;7.386829741218584;11.359159553512804;8.51676939085888;SO
2020-07-21;Valladolid;63432;2862;71147;5108;47186;134579;7970;4.511918274687854;7.179501595288627;5.922172107089517;VA
2020-07-22;Ávila;35500;1696;16603;1728;5019;52103;3424;4.777464788732395;10.4077576341625;6.571598564382089;AV
2020-07-22;Palencia;26160;887;16524;951;34120;42684;1838;3.390672782874618;5.75526506899056;4.306063161840503;PA
2020-07-22;Segovia;25885;2697;22644;2448;40004;48529;5145;10.419161676646707;10.81081081081081;10.60190813740238;SE
2020-07-22;Zamora;33839;1572;12858;638;49275;46697;2210;4.645527350098998;4.961891429460259;4.732638070968156;ZA
2020-07-23;Ávila;35646;1702;16712;1728;5019;52358;3430;4.774729282387926;10.339875538535184;6.551052370220406;AV
2020-07-23;Burgos;47290;2335;37695;2054;9059;84985;4389;4.93761894692324;5.448998540920547;5.164440783667706;BU
2020-07-23;León;51064;2839;45955;2671;24089;97019;5510;5.559689801033996;5.812207594385812;5.6792999309413625;LE
2020-07-23;Segovia;25914;2700;22769;2449;40004;48683;5149;10.419078490391295;10.755852255259343;10.576587309738512;SE
2020-07-23;Soria;26945;1986;10947;1225;42173;37892;3211;7.370569678975691;11.190280442130264;8.47408423941729;SO
2020-07-23;Valladolid;63597;2876;72116;5117;47186;135713;7993;4.522225891158388;7.095512784957568;5.8896347439081005;VA
2020-07-23;Zamora;33847;1572;13057;639;49275;46904;2211;4.64442934381186;4.893926629394195;4.713883677298311;ZA
2020-07-24;Burgos;47314;2337;37953;2058;9059;85267;4395;4.9393414211438476;5.422496245356098;5.154397363575592;BU
2020-07-24;Segovia;25938;2705;22950;2452;40004;48888;5157;10.42871462718791;10.68409586056645;10.54860088365243;SE
2020-07-25;Ávila;35806;1702;16987;1728;5019;52793;3430;4.753393286041446;10.172484841349268;6.497073475650181;AV
2020-07-25;Salamanca;44455;3224;33029;3040;37274;77484;6264;7.2522775840737825;9.204032819643345;8.084249651540963;SA
2020-07-25;Valladolid;63671;2884;73001;5139;47186;136672;8023;4.529534639003628;7.039629594115149;5.870258721610864;VA
2020-07-25;Zamora;33875;1572;13274;640;49275;47149;2212;4.640590405904059;4.821455476872081;4.691509894165305;ZA
2020-07-25;Castilla y León;355533;20154;272502;19924;99999;628035;40078;5.668672106386749;7.311505970598381;6.381491477385815;CyL
2020-07-26;León;51133;2843;46808;2679;24089;97941;5522;5.5600101695578195;5.723380618697658;5.638088236795622;LE
2020-07-26;Palencia;26200;889;16893;955;34120;43093;1844;3.393129770992366;5.65322914816788;4.279117258023344;PA
2020-07-27;Ávila;35974;1705;17261;1728;5019;53235;3433;4.739534107966865;10.011007473495162;6.448764910303371;AV
2020-07-27;Burgos;47352;2339;39093;2079;9059;86445;4418;4.939601284000675;5.318087637172895;5.1107640696396555;BU
2020-07-27;Salamanca;44506;3224;33523;3053;37274;78029;6277;7.243967105558802;9.107180144975091;8.044445014033244;SA
2020-07-27;Valladolid;63734;2891;73641;5144;47186;137375;8035;4.53604041798726;6.98523920098858;5.848953594176525;VA
2020-07-28;Ávila;36143;1710;17376;1729;5019;53519;3439;4.73120659602136;9.950506445672191;6.425755339225322;AV
2020-07-28;Burgos;47383;2342;39918;2086;9059;87301;4428;4.942700968701855;5.225712711057668;5.072106848718801;BU
2020-07-28;Palencia;26243;891;17173;960;34120;43416;1851;3.3951910985786684;5.590170616665696;4.263405196241017;PA
2020-07-28;Salamanca;44540;3228;33733;3056;37274;78273;6284;7.247418051189941;9.059378057095426;8.02831116732462;SA
2020-07-28;Soria;27239;2001;11440;1244;42173;38679;3245;7.3460846580270935;10.874125874125875;8.389565397243983;SO
2020-07-28;Zamora;33933;1574;13542;640;49275;47475;2214;4.6385524415760475;4.726037512922758;4.6635071090047395;ZA
2020-07-28;Castilla y León;356556;20204;278528;20011;99999;635084;40215;5.666431079549916;7.1845559512867645;6.332233216393422;CyL
2020-07-29;Ávila;36270;1713;17483;1731;5019;53753;3444;4.722911497105046;9.901046731110222;6.407084255762468;AV
2020-07-29;Burgos;47410;2344;40525;2097;9059;87935;4441;4.944104619278633;5.174583590376311;5.050321260021607;BU
2020-07-30;Burgos;47440;2348;41379;2120;9059;88819;4468;4.949409780775717;5.123371758621523;5.030455195397381;BU
2020-07-30;León;51361;2858;48441;2683;24089;99802;5541;5.564533400829423;5.538696558700275;5.551992946033145;LE
2020-07-30;Palencia;26280;896;17482;963;34120;43762;1859;3.409436834094368;5.508523052282348;4.247977697545816;PA
2020-07-30;Soria;27445;2022;11702;1265;42173;39147;3287;7.367462197121516;10.81011792855922;8.396556568830306;SO
2020-07-30;Valladolid;63922;2910;75323;5211;47186;139245;8121;4.5524232658552615;6.918205594572707;5.832166325541312;VA
2020-07-31;Burgos;47464;2349;42163;2152;9059;89627;4501;4.949013989549974;5.104001138438916;5.0219241969495805;BU
2020-07-31;Salamanca;44684;3236;34784;3081;37274;79468;6317;7.241965804314744;8.857520699172033;7.949111592087381;SA
2020-07-31;Segovia;26086;2716;23990;2473;40004;50076;5189;10.411715096220195;10.308461859107961;10.36224938094097;SE
2020-08-01;Ávila;36552;1717;17913;1734;5019;54465;3451;4.6974173779820525;9.680120582816949;6.336179197649868;AV
2020-08-01;Palencia;26293;896;17668;971;34120;43961;1867;3.4077511124633935;5.495811636857596;4.246946156820818;PA
2020-08-01;Zamora;34016;1576;14121;660;49275;48137;2236;4.6331138287864535;4.673889951136605;4.645075513638157;ZA
2020-08-02;Salamanca;44686;3236;35215;3104;37274;79901;6340;7.241641677482881;8.814425670878887;7.934819338931928;SA
2020-08-02;Segovia;26104;2717;24184;2480;40004;50288;5197;10.408366533864543;10.254713860403571;10.334473433025773;SE
2020-08-02;Zamora;34018;1576;14224;665;49275;48242;2241;4.632841436886355;4.675196850393701;4.6453297956137805;ZA
2020-08-03;Ávila;36752;1720;18170;1735;5019;54922;3455;4.680017414018285;9.548706659328564;6.2907395943337825;AV
2020-08-03;Burgos;47498;2349;44206;2241;9059;91704;4590;4.94547138826898;5.069447586300503;5.005234231876472;BU
2020-08-03;Valladolid;64073;2926;77082;5270;47186;141155;8196;4.566666146426733;6.836875016216497;5.806383054089476;VA
2020-08-04;Palencia;26331;899;18070;979;34120;44401;1878;3.414226577038472;5.417819590481461;4.229634467692169;PA
2020-08-04;Soria;27840;2044;12495;1351;42173;40335;3395;7.3419540229885065;10.81232492997199;8.417007561671005;SO
2020-08-05;Palencia;26380;902;18250;982;34120;44630;1884;3.419257012888552;5.380821917808219;4.221375756217791;PA
2020-08-05;Salamanca;44824;3247;36447;3170;37274;81271;6417;7.243887203283955;8.697560841770242;7.895805391837187;SA
2020-08-05;Soria;27909;2070;12721;1358;42173;40630;3428;7.416962270235408;10.67526137882242;8.437115431946838;SO
2020-08-05;Zamora;34128;1581;14856;673;49275;48984;2254;4.632559774964838;4.530156165858912;4.601502531438837;ZA
2020-08-06;Palencia;26534;905;18467;993;34120;45001;1898;3.41071832366021;5.377159257053122;4.217684051465523;PA
2020-08-07;León;51835;2870;51448;2722;24089;103283;5592;5.536799459824443;5.2907790390297;5.414250167016838;LE
2020-08-07;Soria;28110;2093;13103;1378;42173;41213;3471;7.445748843827819;10.516675570480043;8.422099822871425;SO
2020-08-07;Zamora;34183;1583;15194;677;49275;49377;2260;4.630956908404762;4.455706199815717;4.577029791198331;ZA
2020-08-08;Palencia;26601;906;18789;1003;34120;45390;1909;3.4058869967294467;5.338229815317473;4.2057721965190575;PA
2020-08-08;Segovia;26155;2719;25418;2516;40004;51573;5235;10.395717835977825;9.898497128019514;10.150660229189693;SE
2020-08-08;Soria;28162;2101;13212;1386;42173;41374;3487;7.460407641502734;10.490463215258854;8.427998259776672;SO
2020-08-08;Valladolid;64466;2974;80431;5441;47186;144897;8415;4.613284522073651;6.764804615135955;5.8075736557692705;VA
2020-08-08;Zamora;34183;1583;15375;682;49275;49558;2265;4.630956908404762;4.435772357723577;4.570402356834416;ZA
2020-08-09;Burgos;47697;2358;51858;2816;9059;99555;5174;4.94370715139317;5.430213274711713;5.1971272161116975;BU
2020-08-09;Palencia;26601;906;18927;1006;34120;45528;1912;3.4058869967294467;5.3151582395519625;4.199613424705675;PA
2020-08-09;Salamanca;44918;3258;38111;3312;37274;83029;6570;7.2532169731510745;8.690404345202172;7.912897903142276;SA
2020-08-09;Segovia;26159;2721;25455;2516;40004;51614;5237;10.401773768110402;9.884109212335494;10.14647188747239;SE
2020-08-09;Soria;28162;2101;13335;1397;42173;41497;3498;7.460407641502734;10.476190476190476;8.429525025905487;SO
2020-08-09;Valladolid;64471;2974;80716;5471;47186;145187;8445;4.612926742256208;6.778086129144159;5.816636475717523;VA
2020-08-09;Zamora;34183;1583;15493;693;49275;49676;2276;4.630956908404762;4.472987800942361;4.581689346968354;ZA
2020-08-10;Burgos;47821;2365;52871;2910;9059;100692;5275;4.945526024131658;5.503962474702577;5.2387478647757515;BU
2020-08-10;León;52025;2870;52662;2756;24089;104687;5626;5.516578567996156;5.23337510918689;5.37411521965478;LE
2020-08-11;Ávila;38038;1758;19858;1777;5019;57896;3535;4.621694095378306;8.948534595628965;6.105775873980932;AV
2020-08-11;Salamanca;45020;3264;39032;3378;37274;84052;6642;7.250111061750333;8.654437384709981;7.902250987483939;SA
2020-08-12;Palencia;27055;918;19653;1021;34120;46708;1939;3.393088153760857;5.195135602706966;4.151323113813479;PA
2020-08-13;Salamanca;45417;3280;40096;3460;37274;85513;6740;7.221965343373626;8.6292897047087;7.88184252686726;SA
2020-08-13;Castilla y León;367785;20702;334336;22717;99999;702121;43419;5.628832062210258;6.7946616577335375;6.183976835901504;CyL
2020-08-14;Soria;29091;2144;14530;1488;42173;43621;3632;7.369976968821973;10.240880935994493;8.326264872423833;SO
2020-08-14;Zamora;34391;1594;16627;737;49275;51018;2331;4.634933558198366;4.432549467733205;4.568975655650947;ZA
2020-08-15;Ávila;39929;1807;20826;1833;5019;60755;3640;4.525532820756843;8.801498127340825;5.991276438153238;AV
2020-08-15;Segovia;26378;2737;27216;2636;40004;53594;5373;10.376070968231103;9.685479129923575;10.025375974922566;SE
2020-08-15;Soria;29113;2145;14736;1506;42173;43849;3651;7.367842544567719;10.219869706840392;8.326301626034802;SO
2020-08-16;Ávila;40086;1808;20989;1838;5019;61075;3646;4.510302848874919;8.756967935585307;5.969709373720835;AV
2020-08-16;Burgos;48822;2382;62863;3403;9059;111685;5785;4.878948015239032;5.413359209710005;5.179746608765725;BU
2020-08-16;Palencia;27458;931;20598;1084;34120;48056;2015;3.390632966712798;5.262646858918341;4.193024804394873;PA
2020-08-16;Valladolid;66270;3030;86817;5870;47186;153087;8900;4.572204617473971;6.761348583802712;5.81368764166781;VA
2020-08-16;Zamora;34393;1594;17177;768;49275;51570;2362;4.634664030471317;4.4710950689876;4.5801822765173545;ZA
2020-08-17;Ávila;40581;1810;21229;1843;5019;61810;3653;4.460215371725685;8.681520561496066;5.910046917974437;AV
2020-08-17;Palencia;27492;932;21021;1113;34120;48513;2045;3.390077113342063;5.294705294705294;4.2153649537237445;PA
2020-08-17;Segovia;26394;2738;27788;2685;40004;54182;5423;10.373569750700916;9.662444220526845;10.008859030674394;SE
2020-08-18;Burgos;49133;2391;65559;3593;9059;114692;5984;4.866383082653206;5.48055949602648;5.217451958288285;BU
2020-08-18;Soria;29760;2185;15253;1550;42173;45013;3735;7.342069892473119;10.161935356978955;8.297602914713528;SO
2020-08-18;Valladolid;66777;2818;88695;5976;47186;155472;8794;4.220015873728979;6.7376966007103;5.656323968302974;VA
2020-08-18;Zamora;34625;1614;17605;799;49275;52230;2413;4.661371841155234;4.538483385401874;4.619950220179973;ZA
2020-08-19;Burgos;49354;2403;67329;3689;9059;116683;6092;4.868906268995421;5.479065484412363;5.22098334804556;BU
2020-08-20;Ávila;41745;1834;22227;1954;5019;63972;3788;4.3933405198227335;8.791109911369057;5.921340586506597;AV
2020-08-20;Burgos;49708;2413;68671;3758;9059;118379;6171;4.854349400498913;5.472470183920432;5.212917831710016;BU
2020-08-20;Soria;30256;2203;15738;1596;42173;45994;3799;7.2812004230565845;10.141059855127716;8.259773013871374;SO
2020-08-21;Ávila;41925;1841;22553;1992;5019;64478;3833;4.391174716756112;8.832527823349444;5.94466329600794;AV
2020-08-21;Burgos;49823;2418;70929;3825;9059;120752;6243;4.8531802581137224;5.392716660322295;5.170100702265801;BU
2020-08-21;Segovia;26454;2748;29463;2849;40004;55917;5597;10.387843048310275;9.66975528629128;10.009478333959262;SE
2020-08-21;Valladolid;68285;2857;91909;6337;47186;160194;9194;4.183934978399355;6.8948633974909965;5.739291109529695;VA
2020-08-21;Zamora;34802;1626;18538;846;49275;53340;2472;4.672145279006953;4.563599093753371;4.634420697412824;ZA
2020-08-21;Castilla y León;381720;21037;375704;25368;99999;757424;46405;5.5111076181494285;6.752124012520495;6.126687297999536;CyL
2020-08-22;Ávila;41953;1843;22885;2026;5019;64838;3869;4.393011226849093;8.852960454446142;5.967179740275765;AV
2020-08-22;Palencia;28587;989;22840;1183;34120;51427;2172;3.4596145100919995;5.1795096322241685;4.223462383572831;PA
2020-08-22;Salamanca;48562;3431;45302;3846;37274;93864;7277;7.0651950084428154;8.489691404353009;7.752706042785307;SA
2020-08-22;Soria;30440;2215;16177;1637;42173;46617;3852;7.276609724047306;10.119305186375719;8.263079992277495;SO
2020-08-22;Zamora;34843;1627;18858;862;49275;53701;2489;4.669517550153546;4.571004348287199;4.634922999571703;ZA
2020-08-23;Burgos;49937;2418;74213;3952;9059;124150;6370;4.842101047319622;5.325212563836525;5.130890052356021;BU
2020-08-23;León;53207;2924;59561;2981;24089;112768;5905;5.495517507094931;5.004952905424691;5.23641458569807;LE
2020-08-24;Ávila;42417;1848;23350;2070;5019;65767;3918;4.356743758398755;8.865096359743042;5.957395046147764;AV
2020-08-24;Burgos;50023;2423;75752;4017;9059;125775;6440;4.843771864942126;5.302830288309219;5.120254422580004;BU
2020-08-24;León;53308;2927;60134;2983;24089;113442;5910;5.490733098221655;4.960588020088469;5.209710689162744;LE
2020-08-24;Valladolid;68879;2868;95087;6595;47186;163966;9463;4.1638235166015765;6.935753573043633;5.771318444067672;VA
2020-08-25;Segovia;26481;2748;30871;2943;40004;57352;5691;10.377251614365017;9.533218878559166;9.92293206862882;SE
2020-08-25;Zamora;35332;1644;19526;901;49275;54858;2545;4.653005773802785;4.614360340059408;4.639250428378723;ZA
2020-06-23;Burgos;46332;2268;26169;1998;9059;72501;4266;4.895104895104895;7.634987962856815;5.884056771630736;BU
2020-06-24;Ávila;31756;1595;12775;1705;5019;44531;3300;5.022672880715455;13.34637964774951;7.410567918977791;AV
2020-06-24;Palencia;25138;835;12949;921;34120;38087;1756;3.3216644124433126;7.112518341184646;4.610497019980571;PA
2020-06-24;Soria;24818;1903;8014;1136;42173;32832;3039;7.6678217422838255;14.175193411529824;9.256213450292398;SO
2020-06-24;Zamora;32741;1549;10031;633;49275;42772;2182;4.731071134052106;6.310437643305752;5.101468250257177;ZA
2020-06-25;Burgos;46499;2282;26931;1999;9059;73430;4281;4.907632422202628;7.422672756303145;5.830042217077488;BU
2020-06-25;Palencia;25165;836;13087;923;34120;38252;1759;3.3220743095569243;7.0528004890349205;4.598452368503607;PA
2020-06-25;Soria;24865;1906;8105;1138;42173;32970;3044;7.665393122863463;14.040715607649599;9.232635729451017;SO
2020-06-25;Castilla y León;336827;19174;213252;19454;99999;550079;38628;5.692536524684779;9.122540468553636;7.022264074796529;CyL
2020-06-26;León;49043;2730;38049;2634;24089;87092;5364;5.566543645372429;6.922652369313253;6.159004271345244;LE
2020-06-26;Salamanca;42305;3013;26707;3011;37274;69012;6024;7.1220895875192065;11.274197775864007;8.728916710137367;SA
2020-06-26;Valladolid;61239;2654;59501;5023;47186;120740;7677;4.3338395466941;8.441874926471824;6.358290541659765;VA
2020-06-27;Ávila;32307;1611;13215;1713;5019;45522;3324;4.986535425759123;12.962542565266745;7.301963885593779;AV
2020-06-27;Burgos;46541;2287;27857;2002;9059;74398;4289;4.913946842568918;7.186703521556521;5.764939917739724;BU
2020-06-27;Segovia;25072;2635;18956;2400;40004;44028;5035;10.509731971920868;12.660898923823591;11.435904424457163;SE
2020-06-27;Valladolid;61244;2658;60102;5030;47186;121346;7688;4.340016981255307;8.369105853382584;6.335602327229576;VA
2020-06-28;Palencia;25642;848;13420;929;34120;39062;1777;3.307074331175415;6.9225037257824145;4.549178229481337;PA
2020-06-28;Salamanca;42117;3013;27058;3011;37274;69175;6024;7.1538808557114715;11.127947372311331;8.70834839176003;SA
2020-06-29;Palencia;25688;854;13613;929;34120;39301;1783;3.3245094985985673;6.824359068537428;4.536780234599629;PA
2020-06-29;Segovia;25123;2637;19405;2409;40004;44528;5046;10.496357919038331;12.414326204586446;11.332195472511678;SE
2020-06-29;Castilla y León;341167;19333;220180;19510;99999;561347;38843;5.666726266022212;8.860931964756109;6.9196058765790145;CyL
2020-06-30;Burgos;46652;2294;28296;2003;9059;74948;4297;4.9172597101946325;7.078739044387899;5.733308427176175;BU
2020-06-30;Salamanca;42681;3064;27584;3014;37274;70265;6078;7.178838358988777;10.926624129930394;8.650110296733793;SA
2020-06-30;Soria;25180;1915;8488;1147;42173;33668;3062;7.605242255758539;13.513195098963243;9.094689319234881;SO
2020-06-30;Zamora;33182;1558;10567;635;49275;43749;2193;4.695316737990477;6.00927415538942;5.012686004251526;ZA
2020-07-01;Zamora;33215;1559;10702;635;49275;43917;2194;4.69366250188168;5.933470379368343;4.995787508254207;ZA
2020-07-02;Burgos;46809;2307;29018;2004;9059;75827;4311;4.9285393834519;6.906058308636019;5.685309981932557;BU
2020-07-02;Segovia;25299;2647;19940;2420;40004;45239;5067;10.46286414482786;12.13640922768305;11.200512831848625;SE
2020-07-02;Soria;25363;1924;8696;1153;42173;34059;3077;7.585853408508457;13.258969641214351;9.034322792800728;SO
2020-07-02;Castilla y León;344417;19521;227433;19556;99999;571850;39077;5.6678386955347735;8.598576284004519;6.833435341435691;CyL
2020-07-03;Burgos;46849;2315;29205;2004;9059;76054;4319;4.941407500693718;6.861838726245506;5.678859757540695;BU
2020-07-03;Palencia;25865;867;14273;935;34120;40138;1802;3.3520201043881697;6.550830238912632;4.489511186406896;PA
2020-07-03;Salamanca;43101;3104;28342;3018;37274;71443;6122;7.2016890559383775;10.648507515348246;8.569069048052294;SA
2020-07-03;Valladolid;62179;2743;63347;5043;47186;125526;7786;4.411457244407275;7.960913697570524;6.202699042429457;VA
2020-07-04;León;49985;2778;40181;2637;24089;90166;5415;5.557667300190057;6.562803314999627;6.005589690127098;LE
2020-07-04;Segovia;25368;2650;20220;2426;40004;45588;5076;10.44623147272154;11.998021760633035;11.134509081337194;SE
2020-07-04;Soria;25488;1930;8881;1154;42173;34369;3084;7.572190834902699;12.994032203580677;8.9732025953621;SO
2020-07-04;Valladolid;62182;2743;63651;5044;47186;125833;7787;4.411244411566048;7.924463087775526;6.188360763869573;VA
2020-07-04;Zamora;33326;1562;10980;636;49275;44306;2198;4.687031146852307;5.7923497267759565;4.960953369746761;ZA
2020-07-05;Palencia;25865;867;14377;935;34120;40242;1802;3.3520201043881697;6.503442999234889;4.477908652651458;PA
2020-07-05;Zamora;33327;1562;11051;636;49275;44378;2198;4.686890509196747;5.755135281874944;4.952904592365587;ZA
2020-07-06;Burgos;46900;2315;29859;2004;9059;76759;4319;4.936034115138592;6.71154425801266;5.62670175484308;BU
2020-07-06;León;50080;2783;40359;2638;24089;90439;5421;5.557108626198083;6.536336380980698;5.9940954676632865;LE
2020-07-06;Salamanca;43207;3112;28838;3018;37274;72045;6130;7.202536626009675;10.465358207920106;8.508571031993894;SA
2020-07-06;Segovia;25430;2656;20432;2426;40004;45862;5082;10.444357058592214;11.87353171495693;11.081069294841045;SE
2020-07-06;Soria;25596;1932;8960;1155;42173;34556;3087;7.548054383497421;12.890625;8.933325616390785;SO
2020-07-06;Valladolid;62343;2760;64324;5046;47186;126667;7806;4.427120927770559;7.844661401654126;6.162615361538522;VA
2020-07-06;Zamora;33427;1563;11248;637;49275;44675;2200;4.675860831064709;5.663229018492177;4.924454392837157;ZA
2020-07-07;Burgos;46930;2316;30083;2004;9059;77013;4320;4.9350095887492005;6.661569657281522;5.609442561645436;BU
2020-07-07;León;50190;2790;40504;2638;24089;90694;5428;5.558876270173341;6.512936993877148;5.984960416345072;LE
2020-07-07;Salamanca;43318;3124;29067;3019;37274;72385;6143;7.211782630777044;10.386348780403894;8.486564896041997;SA
2020-07-07;Segovia;25457;2659;20606;2427;40004;46063;5086;10.44506422594964;11.778122876831992;11.041399821982937;SE
2020-07-07;Soria;25698;1933;9078;1157;42173;34776;3090;7.521986146781851;12.745098039215685;8.88543823326432;SO
2020-07-07;Castilla y León;346876;19681;235129;19585;99999;582005;39266;5.673785444942862;8.329470205716861;6.746677434042662;CyL
2020-07-08;León;50304;2797;40636;2638;24089;90940;5435;5.560194020356234;6.491780687075499;5.976468000879701;LE
2020-07-08;Valladolid;62584;2780;65548;5048;47186;128132;7828;4.442029911798543;7.701226582046744;6.109324758842444;VA
2020-07-10;Palencia;26005;877;15168;940;34120;41173;1817;3.3724283791578538;6.197257383966245;4.413086245840721;PA
2020-07-10;Salamanca;43586;3150;29827;3019;37274;73413;6169;7.227091267838297;10.121701813792871;8.403143857354964;SA
2020-07-11;Ávila;33925;1665;15147;1724;5019;49072;3389;4.907885040530583;11.381791773948637;6.9061786762308435;AV
2020-07-11;Zamora;33583;1567;11703;638;49275;45286;2205;4.666051275943185;5.451593608476459;4.869054453915117;ZA
2020-07-11;Castilla y León;349069;19815;244047;19636;99999;593116;39451;5.6765281362710525;8.045991141050699;6.651481329116058;CyL
2020-07-12;Palencia;26005;877;15296;940;34120;41301;1817;3.3724283791578538;6.145397489539748;4.399409215273238;PA
2020-07-12;Salamanca;43589;3150;30227;3020;37274;73816;6170;7.226593865424763;9.991067588579746;8.35862143708681;SA
2020-07-12;Valladolid;62819;2812;66944;5055;47186;129763;7867;4.476352695840431;7.5510874760994255;6.062591031341754;VA
2020-07-13;Burgos;47063;2323;32526;2011;9059;79589;4334;4.935936935596966;6.182746110803665;5.445476133636558;BU
2020-07-13;Segovia;25619;2675;21368;2435;40004;46987;5110;10.441469222061752;11.39554473979783;10.875348500649116;SE
2020-07-13;Valladolid;62904;2825;67520;5071;47186;130424;7896;4.490970367544194;7.510367298578199;6.05410047230571;VA
2020-07-14;Ávila;34480;1677;15535;1725;5019;50015;3402;4.86368909512761;11.103958802703573;6.801959412176347;AV
2020-07-14;Palencia;26059;880;15559;941;34120;41618;1821;3.376952300548755;6.047946526126358;4.375510596376568;PA
2020-07-14;Segovia;25645;2677;21539;2437;40004;47184;5114;10.438682004289335;11.314359998142903;10.83841980332316;SE
2020-07-14;Soria;26199;1952;9820;1181;42173;36019;3133;7.450666055956335;12.026476578411405;8.698187067936367;SO
2020-07-15;León;50726;2817;43587;2651;24089;94313;5468;5.553365138193431;6.082088696170876;5.797716115487791;LE
2020-07-15;Soria;26289;1960;9937;1183;42173;36226;3143;7.455589790406634;11.905001509509912;8.676088996853089;SO
2020-07-15;Valladolid;63069;2841;68715;5080;47186;131784;7921;4.504590210721591;7.392854544131558;6.0105930917258545;VA
2020-07-15;Zamora;33669;1570;12166;638;49275;45835;2208;4.663043155424871;5.244122965641953;4.817279371659213;ZA
2020-07-15;Castilla y León;351000;19925;252252;19695;99999;603252;39620;5.676638176638177;7.807668521954236;6.567736203112464;CyL
2020-07-16;Valladolid;63155;2846;69081;5080;47186;132236;7926;4.506373208772069;7.353686252370406;5.993829214434799;VA
2020-07-17;Ávila;35000;1689;15948;1725;5019;50948;3414;4.825714285714286;10.81640331075997;6.700949988223287;AV
2020-07-17;León;50874;2827;44160;2656;24089;95034;5483;5.556865982623737;6.0144927536231885;5.769514068649115;LE
2020-07-17;Salamanca;43971;3191;31262;3027;37274;75233;6218;7.257055786768552;9.682681850169535;8.264990097430648;SA
2020-07-17;Segovia;25737;2687;22017;2442;40004;47754;5129;10.440222248125266;11.09142935004769;10.74046153201826;SE
2020-07-17;Soria;26472;1968;10169;1197;42173;36641;3165;7.43427017225748;11.771068934998524;8.637864687099151;SO
2020-07-18;Ávila;35035;1690;16032;1725;5019;51067;3415;4.823747680890538;10.759730538922156;6.6872931638827415;AV
2020-07-18;Palencia;26109;883;16049;950;34120;42158;1833;3.3819755639817686;5.919371923484329;4.347929218653636;PA
2020-07-18;Soria;26565;1971;10293;1203;42173;36858;3174;7.419536984754376;11.687554648790439;8.611427641217647;SO
2020-07-18;Zamora;33732;1571;12392;638;49275;46124;2209;4.657298707458793;5.148482892188508;4.789263723874773;ZA
2020-07-18;Castilla y León;352490;20001;257745;19760;99999;610235;39761;5.674203523504213;7.66649207550098;6.515686579760256;CyL
2020-07-19;Soria;26593;1972;10407;1204;42173;37000;3176;7.415485278080698;11.569136158354954;8.583783783783785;SO
2020-07-20;Ávila;35230;1693;16228;1725;5019;51458;3418;4.805563440249787;10.629775696327336;6.642310233588558;AV
2020-07-20;Soria;26698;1975;10484;1208;42173;37182;3183;7.397557869503333;11.52231972529569;8.560593835726966;SO
2020-07-21;Salamanca;44226;3203;32054;3029;37274;76280;6232;7.24234613123502;9.449678667249017;8.169900367068694;SA
2020-07-22;Burgos;47255;2333;37034;2048;9059;84289;4381;4.937043699079462;5.530053464384079;5.197593992098613;BU
2020-07-22;Soria;26865;1983;10830;1214;42173;37695;3197;7.3813512004466775;11.20960295475531;8.481230932484413;SO
2020-07-22;Valladolid;63495;2868;71605;5112;47186;135100;7980;4.516891093786912;7.139166259339431;5.9067357512953365;VA
2020-07-22;Castilla y León;354343;20086;266063;19845;99999;620406;39931;5.668518920932543;7.458759767423505;6.436269152780598;CyL
2020-07-23;Palencia;26183;888;16636;953;34120;42819;1841;3.3915135775121263;5.728540514546767;4.299493215628576;PA
2020-07-23;Salamanca;44379;3220;32646;3036;37274;77025;6256;7.255683994682169;9.299761073332109;8.12203829925349;SA
2020-07-24;Ávila;35775;1702;16839;1728;5019;52614;3430;4.7575122292103424;10.261892036344202;6.519177405253354;AV
2020-07-24;León;51129;2842;46263;2675;24089;97392;5517;5.558489311349724;5.7821585284136345;5.664736323311977;LE
2020-07-24;Soria;27017;1992;11083;1228;42173;38100;3220;7.373135433245734;11.080032482179915;8.451443569553806;SO
2020-07-24;Valladolid;63669;2884;72657;5137;47186;136326;8021;4.529676922835288;7.070206587114799;5.88369056526268;VA
2020-07-25;León;51131;2842;46724;2679;24089;97855;5521;5.558271889851558;5.7336700624946495;5.64202135813193;LE
2020-07-26;Valladolid;63673;2885;73250;5140;47186;136923;8025;4.530962888508474;7.017064846416382;5.860958348853005;VA
2020-07-26;Zamora;33875;1572;13314;640;49275;47189;2212;4.640590405904059;4.806970106654649;4.68753311153023;ZA
2020-07-27;León;51185;2845;47213;2679;24089;98398;5524;5.558269024128163;5.674284624997353;5.613935242586232;LE
2020-07-27;Soria;27206;1998;11321;1238;42173;38527;3236;7.343968242299493;10.935429732355798;8.399304383938537;SO
2020-07-27;Zamora;33889;1572;13406;640;49275;47295;2212;4.638673315825194;4.773981799194391;4.677027169891109;ZA
2020-07-27;Castilla y León;356058;20169;275754;19970;99999;631812;40139;5.664526565896567;7.241962038628633;6.352997410622146;CyL
2020-07-28;Segovia;26030;2710;23432;2458;40004;49462;5168;10.41106415674222;10.489928303175144;10.448425053576484;SE
2020-07-28;Valladolid;63794;2899;74258;5158;47186;138052;8057;4.544314512336584;6.94605295052385;5.8362066467707825;VA
2020-07-29;Valladolid;63852;2902;74733;5172;47186;138585;8074;4.544885046670425;6.920637469391032;5.826027347837067;VA
2020-07-29;Zamora;33953;1574;13669;641;49275;47622;2215;4.635820104261774;4.689443265783891;4.651211624879258;ZA
2020-07-30;Segovia;26073;2715;23775;2469;40004;49848;5184;10.413070992981245;10.384858044164037;10.399614829080404;SE
2020-07-30;Castilla y León;357537;20272;284044;20154;99999;641581;40426;5.669902695385373;7.095379589077748;6.300997068180012;CyL
2020-07-31;Ávila;36523;1717;17814;1733;5019;54337;3450;4.701147222298277;9.728303581452789;6.34926477354289;AV
2020-07-31;Valladolid;63993;2913;75964;5235;47186;139957;8148;4.552060381604238;6.89142225264599;5.821788120637053;VA
2020-07-31;Zamora;34014;1576;13950;654;49275;47964;2230;4.633386252719469;4.688172043010753;4.649320323576015;ZA
2020-08-01;León;51418;2858;49170;2687;24089;100588;5545;5.5583647749815235;5.4647142566605655;5.512585994353203;LE
2020-08-01;Soria;27517;2028;12081;1316;42173;39598;3344;7.369989461060435;10.89313798526612;8.44487095307844;SO
2020-08-01;Castilla y León;358046;20293;289477;20392;99999;647523;40685;5.667707501270787;7.04442840018378;6.283174497276544;CyL
2020-08-02;Ávila;36596;1718;18074;1734;5019;54670;3452;4.694502131380478;9.593891778244993;6.3142491311505395;AV
2020-08-02;Burgos;47472;2349;43539;2225;9059;91011;4574;4.948179979777553;5.110360825926181;5.025766116183758;BU
2020-08-02;Castilla y León;358146;20296;291147;20443;99999;649293;40739;5.6669626353498295;7.0215389476793515;6.274363037950509;CyL
2020-08-03;Palencia;26309;896;17888;972;34120;44197;1868;3.4056786650955946;5.433810375670841;4.226531212525737;PA
2020-08-03;Segovia;26110;2717;24389;2481;40004;50499;5198;10.40597472232861;10.172618803558981;10.293273134121469;SE
2020-08-03;Castilla y León;358655;20318;293479;20505;99999;652134;40823;5.665054160683666;6.986871292324152;6.259909773144782;CyL
2020-08-04;Ávila;36905;1721;18411;1735;5019;55316;3456;4.663324752743531;9.42371408397154;6.2477402559838024;AV
2020-08-04;Burgos;47522;2354;45207;2306;9059;92729;4660;4.953495223265014;5.100979936735461;5.025396585749873;BU
2020-08-04;León;51524;2863;49892;2695;24089;101416;5558;5.556633801723469;5.401667602020364;5.480397570403092;LE
2020-08-04;Segovia;26132;2717;24594;2482;40004;50726;5199;10.397214143578754;10.091892331462958;10.249181879115246;SE
2020-08-04;Valladolid;64172;2939;77891;5293;47186;142063;8232;4.579879074985975;6.795393562799297;5.794612249494943;VA
2020-08-05;Burgos;47605;2354;46460;2449;9059;94065;4803;4.944858733326331;5.2712010331467924;5.106043693190879;BU
2020-08-05;León;51583;2863;50556;2707;24089;102139;5570;5.550278192427738;5.35445842234354;5.453352783951281;LE
2020-08-06;Ávila;37220;1738;18821;1737;5019;56041;3475;4.669532509403546;9.229052653950374;6.20081725879267;AV
2020-08-06;Salamanca;44873;3250;37011;3204;37274;81884;6454;7.24266262563234;8.65688579071087;7.88188168628792;SA
2020-08-06;Segovia;26150;2718;25071;2498;40004;51221;5216;10.393881453154876;9.963703083243589;10.183323246324749;SE
2020-08-06;Soria;27988;2084;12893;1363;42173;40881;3447;7.446048306417036;10.571628015202048;8.431789829015925;SO
2020-08-06;Valladolid;64363;2960;79199;5365;47186;143562;8325;4.5989155260009635;6.774075430245332;5.798888285200819;VA
2020-08-07;Ávila;37385;1743;19055;1745;5019;56440;3488;4.662297712986492;9.1577013907111;6.180014174344437;AV
2020-08-07;Salamanca;44914;3258;37368;3252;37274;82282;6510;7.253862938059402;8.702633269107258;7.911815463892467;SA
2020-08-07;Segovia;26155;2719;25318;2515;40004;51473;5234;10.395717835977825;9.93364404771309;10.168437821770638;SE
2020-08-07;Valladolid;64449;2968;79897;5406;47186;144346;8374;4.605191701965896;6.766211497302778;5.801338450667147;VA
2020-08-07;Castilla y León;361323;20498;309239;21308;99999;670562;41806;5.673040465179355;6.890463363288589;6.234471980219577;CyL
2020-08-08;Ávila;37438;1744;19314;1754;5019;56752;3498;4.6583685025909505;9.08149528839184;6.1636594305046515;AV
2020-08-08;León;51835;2870;51977;2738;24089;103812;5608;5.536799459824443;5.267714566058064;5.402072978075752;LE
2020-08-09;León;51896;2870;52349;2750;24089;104245;5620;5.530291351934639;5.253204454717378;5.391145858314547;LE
2020-08-10;Palencia;26649;909;19141;1008;34120;45790;1917;3.4110097939885176;5.266182540097174;4.186503603406858;PA
2020-08-10;Salamanca;44993;3260;38416;3325;37274;83409;6585;7.245571533349632;8.65524781341108;7.894831493004352;SA
2020-08-10;Valladolid;64639;2979;81277;5495;47186;145916;8474;4.608672782685376;6.760830247179399;5.807450862139861;VA
2020-08-10;Zamora;34235;1583;15581;695;49275;49816;2278;4.623922885935446;4.46056093960593;4.572828007066003;ZA
2020-08-11;Burgos;47992;2368;54482;2977;9059;102474;5345;4.934155692615436;5.464190007708968;5.215957218416379;BU
2020-08-11;León;52095;2873;53187;2762;24089;105282;5635;5.514924656876859;5.192998289055597;5.352291939742786;LE
2020-08-11;Valladolid;64974;2990;82272;5555;47186;147246;8545;4.601840736294518;6.751993387786853;5.803213669641281;VA
2020-08-11;Zamora;34248;1584;15692;698;49275;49940;2282;4.625087596355992;4.448126433851645;4.5694833800560675;ZA
2020-08-11;Castilla y León;363639;20576;323780;22142;99999;687419;42718;5.658358976897417;6.838594107109766;6.214259425474129;CyL
2020-08-12;Burgos;48161;2373;56341;3058;9059;104502;5431;4.927223271942028;5.427663690740314;5.197029721919198;BU
2020-08-12;Salamanca;45040;3271;39590;3416;37274;84630;6687;7.262433392539965;8.628441525637786;7.901453385324353;SA
2020-08-12;Segovia;26216;2724;26280;2563;40004;52496;5287;10.390601159597193;9.752663622526637;10.071243523316062;SE
2020-08-12;Soria;28474;2111;14007;1444;42173;42481;3555;7.413780993186767;10.309131148711359;8.368447070455028;SO
2020-08-12;Castilla y León;365404;20631;329052;22383;99999;694456;43014;5.646079407997723;6.802268334488167;6.19391293328879;CyL
2020-08-13;Burgos;48493;2381;58126;3165;9059;106619;5546;4.909987008434207;5.445067611740013;5.201699509468294;BU
2020-08-13;Palencia;27298;928;19932;1034;34120;47230;1962;3.3995164480914353;5.187637969094923;4.154139318229939;PA
2020-08-14;Ávila;39791;1804;20650;1819;5019;60441;3623;4.53368852253022;8.808716707021793;5.99427540907662;AV
2020-08-14;Burgos;48822;2382;59947;3251;9059;108769;5633;4.878948015239032;5.423123759320733;5.178865301694416;BU
2020-08-14;Salamanca;45629;3294;40947;3510;37274;86576;6804;7.219093120603125;8.572056560920215;7.858990944372575;SA
2020-08-14;Castilla y León;370027;20797;340781;23065;99999;710808;43862;5.620400673464369;6.768276400386172;6.170724021114;CyL
2020-08-15;Salamanca;45633;3295;41683;3534;37274;87316;6829;7.220651721342011;8.478276515605883;7.82101791195199;SA
2020-08-15;Castilla y León;370503;20807;345404;23297;99999;715907;44104;5.615878953746663;6.74485529988072;6.1605767229542385;CyL
2020-08-16;Salamanca;45637;3297;42001;3574;37274;87638;6871;7.224401253368977;8.509321206637937;7.840206303201808;SA
2020-08-16;Soria;29113;2145;14885;1523;42173;43998;3668;7.367842544567719;10.231776956667787;8.336742579208147;SO
2020-08-16;Castilla y León;370704;20811;348598;23548;99999;719302;44359;5.6139129871811475;6.755058835678919;6.166950738354682;CyL
2020-08-17;Burgos;48923;2386;64074;3514;9059;112997;5900;4.8770516934775054;5.484283796859881;5.221377558696248;BU
2020-08-17;León;52571;2889;56296;2834;24089;108867;5723;5.495425234444846;5.034105442660224;5.256873065299861;LE
2020-08-17;Salamanca;45814;3314;42431;3606;37274;88245;6920;7.233596717160694;8.498503452664325;7.841804068219163;SA
2020-08-17;Soria;29191;2145;15008;1529;42173;44199;3674;7.348155253331506;10.187899786780385;8.312405258037513;SO
2020-08-17;Valladolid;66529;2825;87320;5895;47186;153849;8720;4.246268544544484;6.7510306917086575;5.667895143939837;VA
2020-08-17;Zamora;34408;1593;17262;769;49275;51670;2362;4.629737270402233;4.454871973120148;4.571317979485195;ZA
2020-08-18;Ávila;40938;1814;21600;1860;5019;62538;3674;4.4310909179735205;8.61111111111111;5.874828104512456;AV
2020-08-18;Palencia;27593;941;21385;1116;34120;48978;2057;3.4102852172652485;5.218611176057984;4.199844828290253;PA
2020-08-18;Segovia;26411;2739;28190;2721;40004;54601;5460;10.370678883798417;9.65235899255055;9.999816853171186;SE
2020-08-18;Castilla y León;373943;20725;357982;24098;99999;731925;44823;5.542288530604932;6.731623377711729;6.123988113536223;CyL
2020-08-19;Ávila;41303;1823;21946;1891;5019;63249;3714;4.4137229741181025;8.616604392600017;5.872029597305886;AV
2020-08-19;León;52773;2910;57525;2863;24089;110298;5773;5.514183389233131;4.976966536288571;5.234002429781139;LE
2020-08-19;Palencia;27639;955;21819;1131;34120;49458;2086;3.45526249140707;5.183555616664375;4.217720085729305;PA
2020-08-19;Segovia;26426;2742;28588;2766;40004;55014;5508;10.376144705971392;9.675388274800616;10.011996946231868;SE
2020-08-19;Valladolid;67049;2824;89902;6096;47186;156951;8920;4.211845068531969;6.780716780494315;5.683302431969213;VA
2020-08-19;Zamora;34661;1615;17924;813;49275;52585;2428;4.659415481376763;4.535817897790672;4.6172862983740615;ZA
2020-08-19;Castilla y León;375739;20823;364017;24496;99999;739756;45319;5.541878804169916;6.729356046558266;6.126209182487199;CyL
2020-08-20;León;53041;2916;58259;2918;24089;111300;5834;5.4976339058464205;5.008668188606053;5.241689128481581;LE
2020-08-20;Segovia;26442;2746;28960;2800;40004;55402;5546;10.384993570834279;9.668508287292818;10.010468936139489;SE
2020-08-20;Castilla y León;378861;20944;369245;24960;99999;748106;45904;5.528148846146739;6.759739468374656;6.136028851526388;CyL
2020-08-21;Palencia;28377;986;22603;1164;34120;50980;2150;3.4746449589456248;5.149758881564394;4.217340133385641;PA
2020-08-21;Salamanca;48461;3430;44810;3805;37274;93271;7235;7.077856420626897;8.491408167819683;7.756966259609096;SA
2020-08-21;Soria;30388;2207;15914;1604;42173;46302;3811;7.26273529024615;10.079175568681665;8.230745972096237;SO
2020-08-22;Burgos;49937;2418;72393;3901;9059;122330;6319;4.842101047319622;5.388642548312682;5.16553584566337;BU
2020-08-22;León;53207;2924;59382;2958;24089;112589;5882;5.495517507094931;4.981307466909164;5.224311433621401;LE
2020-08-22;Valladolid;68336;2857;93204;6444;47186;161540;9301;4.180812456099274;6.913866357667054;5.757707069456481;VA
2020-08-23;Ávila;42032;1844;23204;2053;5019;65236;3897;4.387133612485726;8.847612480606792;5.973695505549084;AV
2020-08-23;Palencia;28591;989;23128;1215;34120;51719;2204;3.4591304956105065;5.253372535454861;4.261489974670817;PA
2020-08-23;Valladolid;68405;2857;94107;6491;47186;162512;9348;4.176595278122944;6.897467776042165;5.7521906074628335;VA
2020-08-24;Salamanca;49127;3456;46603;3940;37274;95730;7396;7.034828098601584;8.454391348196468;7.725895748459208;SA
2020-08-24;Segovia;26464;2748;30273;2900;40004;56737;5648;10.38391777509069;9.579493277838338;9.95470328004653;SE
2020-08-25;Ávila;42662;1848;23642;2113;5019;66304;3961;4.331723782288687;8.937484138397767;5.973998552123552;AV
2020-08-25;Burgos;50225;2430;77478;4018;9059;127703;6448;4.838227974116476;5.185988280544154;5.049215758439504;BU
2020-08-25;León;53562;2941;61036;3068;24089;114598;6009;5.490833053284044;5.026541713087358;5.243547007801183;LE
2020-08-25;Valladolid;69615;2876;96725;6639;47186;166340;9515;4.1312935430582485;6.863789092788834;5.720211614764939;VA
2020-08-25;Castilla y León;388188;21202;397174;26594;99999;785362;47796;5.461786557029068;6.695805868460675;6.085855949231055;CyL
2020-05-02;Soria;7629;895;3020;978;42173;10649;1873;11.73155066194783;32.384105960264904;17.58850596300122;SO
2020-05-03;Burgos;12587;721;9211;1788;9059;21798;2509;5.7281321998887735;19.41157311909673;11.510230296357465;BU
2020-05-04;León;16432;986;14836;2447;24089;31268;3433;6.000486854917235;16.493664060393638;10.979275937060255;LE
2020-05-05;Burgos;14145;765;9595;1803;9059;23740;2568;5.408271474019088;18.791036998436685;10.817186183656275;BU
2020-05-06;Burgos;15242;792;9849;1815;9059;25091;2607;5.196168481826532;18.428266829119707;10.390179745725558;BU
2020-05-06;Salamanca;9708;1009;12355;2781;37274;22063;3790;10.393489905232798;22.509105625252936;17.178080950006798;SA
2020-05-06;Soria;10213;1114;3320;985;42173;13533;2099;10.907666699304809;29.668674698795183;15.510234242222715;SO
2020-05-07;León;18573;1111;15891;2459;24089;34464;3570;5.9818015398697035;15.474167767918948;10.358635097493037;LE
2020-05-07;Palencia;7575;285;5039;777;34120;12614;1062;3.762376237623762;15.419726136138124;8.419216743301094;PA
2020-05-07;Salamanca;11743;1088;12777;2786;37274;24520;3874;9.26509409861194;21.8048055099006;15.799347471451878;SA
2020-05-08;Ávila;9726;653;6213;1608;5019;15939;2261;6.713962574542463;25.88121680347658;14.185331576635923;AV
2020-05-09;León;19429;1166;16950;2496;24089;36379;3662;6.001338205774872;14.725663716814157;10.066247010638005;LE
2020-05-09;Soria;11600;1208;3649;998;42173;15249;2206;10.413793103448276;27.349958892847354;14.466522394911141;SO
2020-05-10;León;19450;1166;17051;2499;24089;36501;3665;5.994858611825193;14.65603190428714;10.040820799430152;LE
2020-05-11;Ávila;11230;731;6542;1617;5019;17772;2348;6.509349955476402;24.717211861815958;13.211793832995724;AV
2020-05-11;Castilla y León;135062;8449;109273;18146;99999;244335;26595;6.255645555374569;16.60611495977963;10.884646080176806;CyL
2020-05-13;Soria;13602;1350;3921;1001;42173;17523;2351;9.92501102779003;25.529201734251465;13.416652399703247;SO
2020-05-14;Burgos;24218;1216;11832;1858;9059;36050;3074;5.021058716657032;15.703177822853279;8.527045769764216;BU
2020-05-15;Ávila;14053;890;6991;1622;5019;21044;2512;6.33316729523945;23.20125876126448;11.936894126591904;AV
2020-05-15;Palencia;12999;410;6393;819;34120;19392;1229;3.154088776059697;12.810886907555139;6.337665016501651;PA
2020-05-15;Castilla y León;172898;11002;120257;18350;99999;293155;29352;6.363289338222536;15.258987002835594;10.012450751309036;CyL
2020-05-16;Burgos;26302;1339;12516;1873;9059;38818;3212;5.090867614630066;14.964844998402047;8.274511824411356;BU
2020-05-16;León;25326;1612;20195;2550;24089;45521;4162;6.36500039485114;12.626887843525624;9.143032885920784;LE
2020-05-16;Palencia;13035;411;6544;823;34120;19579;1234;3.1530494821634067;12.57640586797066;6.302671229378416;PA
2020-05-17;Salamanca;21705;1689;15682;2821;37274;37387;4510;7.781617138908086;17.988776941716615;12.063016556557091;SA
2020-05-17;Castilla y León;176468;11187;123534;18431;99999;300002;29618;6.339392977763674;14.919779170107015;9.872600849327672;CyL
2020-05-19;Ávila;18769;1129;7563;1624;5019;26332;2753;6.015237892269167;21.472960465423775;10.454959744797204;AV
2020-05-19;Segovia;14554;1648;12703;2336;40004;27257;3984;11.323347533324172;18.389356844839803;14.616428807278863;SE
2020-05-19;Zamora;19889;1223;5933;612;49275;25822;1835;6.1491276585047006;10.315186246418339;7.106343428084578;ZA
2020-05-20;Soria;16072;1501;4620;1018;42173;20692;2519;9.339223494275759;22.034632034632036;12.173786970809974;SO
2020-05-21;Salamanca;26671;1956;16943;2838;37274;43614;4794;7.333808256158374;16.750280351767692;10.991883340211858;SA
2020-05-22;Ávila;21269;1222;7952;1631;5019;29221;2853;5.745451126052001;20.510563380281692;9.763526231135144;AV
2020-05-25;Salamanca;28894;2057;18042;2861;37274;46936;4918;7.119125077870839;15.857443742378893;10.478097835350264;SA
2020-05-25;Valladolid;40973;1712;42773;4837;47186;83746;6549;4.178361359919947;11.308535758539264;7.820074988656174;VA
2020-05-26;Burgos;34940;1834;15708;1918;9059;50648;3752;5.248998282770464;12.210338680926917;7.407992418259359;BU
2020-05-26;Zamora;26037;1390;6805;613;49275;32842;2003;5.338556669355148;9.008082292432034;6.098897752877413;ZA
2020-05-27;León;34008;2078;24678;2581;24089;58686;4659;6.110326981886615;10.458708161115164;7.9388610571516205;LE
2020-05-27;Palencia;19469;619;8039;852;34120;27508;1471;3.1794134264728537;10.598333126010697;5.3475352624690995;PA
2020-05-27;Segovia;19687;2272;14397;2351;40004;34084;4623;11.540610555188703;16.329790928665695;13.563548879239526;SE
2020-05-29;Valladolid;45865;1934;44961;4864;47186;90826;6798;4.216722991387768;10.818264718311426;7.484640961839122;VA
2020-05-29;Zamora;27739;1438;7386;614;49275;35125;2052;5.184036915534086;8.313024641213106;5.841992882562278;ZA
2020-05-30;Burgos;38368;1954;17441;1937;9059;55809;3891;5.0927856547122605;11.106014563385127;6.971993764446595;BU
2020-05-30;Segovia;20410;2352;15021;2353;40004;35431;4705;11.52376286134248;15.664736036215965;13.279331658716941;SE
2020-05-30;Valladolid;45873;1935;45263;4865;47186;91136;6800;4.218167549538944;10.748293307999912;7.461376404494382;VA
2020-05-31;Ávila;25060;1359;9158;1671;5019;34218;3030;5.422984836392657;18.24634199606901;8.854988602489918;AV
2020-05-31;Soria;19368;1690;5826;1069;42173;25194;2759;8.72573316811235;18.348781325094404;10.951020084147018;SO
2020-05-31;Valladolid;45877;1935;45395;4870;47186;91272;6805;4.217799768947403;10.728053750413041;7.455736699097204;VA
2020-05-31;Zamora;27790;1439;7551;617;49275;35341;2056;5.178121626484347;8.17110316514369;5.817605613876235;ZA
2020-06-01;Ávila;25435;1376;9343;1671;5019;34778;3047;5.409868291724003;17.885047629241143;8.761285870377824;AV
2020-06-01;Burgos;38997;1989;17965;1944;9059;56962;3933;5.100392337872144;10.821040912886168;6.9046030687124755;BU
2020-06-02;Salamanca;33240;2390;20231;2922;37274;53471;5312;7.190132370637786;14.44318125648757;9.934356941145667;SA
2020-06-05;Burgos;41253;2122;20328;1974;9059;61581;4096;5.143868324727899;9.710743801652892;6.651402218216658;BU
2020-06-05;Palencia;21634;721;9874;881;34120;31508;1602;3.3327170195063323;8.922422523799879;5.0844230036816045;PA
2020-06-08;Palencia;21975;734;10135;883;34120;32110;1617;3.340159271899886;8.71238283177109;5.035814388041109;PA
2020-06-08;Salamanca;35700;2586;21907;2959;37274;57607;5545;7.243697478991597;13.507098187793856;9.62556633742427;SA
2020-06-08;Segovia;21958;2491;16429;2365;40004;38387;4856;11.344384734493124;14.39527664495709;12.650115924661995;SE
2020-06-08;Valladolid;51443;2247;49928;4919;47186;101371;7166;4.3679412164920395;9.852187149495272;7.069082873800199;VA
2020-06-08;Zamora;29527;1477;8330;622;49275;37857;2099;5.0022013750127;7.466986794717887;5.544549224714055;ZA
2020-06-08;Castilla y León;291735;17336;175518;19112;99999;467253;36448;5.942379214012717;10.888911678574278;7.800484962108323;CyL
2020-06-09;León;41858;2464;31294;2617;24089;73152;5081;5.8865688757226815;8.362625423403848;6.9458114610673665;LE
2020-06-09;Palencia;22250;743;10347;884;34120;32597;1627;3.339325842696629;8.543539190103413;4.991256864128601;PA
2020-06-10;Ávila;28060;1497;10658;1683;5019;38718;3180;5.334996436208125;15.790955151060238;8.213234154656748;AV
2020-06-10;Burgos;42503;2183;22140;1984;9059;64643;4167;5.136108039432511;8.96115627822945;6.446173599616355;BU
2020-06-10;Palencia;22600;761;10438;886;34120;33038;1647;3.3672566371681416;8.48821613335888;4.985168593740541;PA
2020-06-10;Segovia;22464;2519;16798;2370;40004;39262;4889;11.213497150997151;14.10882247886653;12.452243899954155;SE
2020-06-11;Ávila;28423;1512;10790;1684;5019;39213;3196;5.31963550645604;15.607043558850789;8.150358299543518;AV
2020-06-11;Burgos;42970;2195;22803;1988;9059;65773;4183;5.108215033744473;8.718151120466604;6.359752482021499;BU
2020-06-11;Segovia;22727;2534;16967;2373;40004;39694;4907;11.149733796805561;13.98597277067248;12.362069834231875;SE
2020-06-11;Valladolid;53959;2358;51629;4930;47186;105588;7288;4.369984617950666;9.548896937767534;6.902299503731485;VA
2020-06-14;León;45117;2579;33895;2625;24089;79012;5204;5.716248864064543;7.744505089246201;6.586341315243255;LE
2020-06-14;Palencia;23406;789;11167;900;34120;34573;1689;3.370930530633171;8.059460911614579;4.885315130303995;PA
2020-06-14;Segovia;22943;2550;17310;2375;40004;40253;4925;11.114501155036395;13.720392836510687;12.235112910838945;SE
2020-06-14;Soria;22553;1838;7162;1114;42173;29715;2952;8.149691837006163;15.554314437308015;9.934376577486118;SO
2020-06-14;Zamora;30747;1499;9007;628;49275;39754;2127;4.875272384297655;6.972354835128233;5.350404990692761;ZA
2020-06-15;Burgos;43878;2211;24122;1991;9059;68000;4202;5.038971694243129;8.253876129674156;6.179411764705883;BU
2020-06-15;León;45528;2593;34287;2626;24089;79815;5219;5.695396239676683;7.658879458686966;6.538871139510118;LE
2020-06-15;Palencia;23753;796;11317;901;34120;35070;1697;3.3511556434976635;7.961473888839798;4.838893641288851;PA
2020-06-15;Salamanca;37990;2736;23639;2985;37274;61629;5721;7.201895235588313;12.627437708870934;9.282967434162488;SA
2020-06-15;Segovia;23173;2556;17495;2376;40004;40668;4932;11.030078108143098;13.581023149471278;12.12747123045146;SE
2020-06-15;Valladolid;55554;2432;53064;4941;47186;108618;7373;4.377722576232134;9.311397557666215;6.788009353882414;VA
2020-06-15;Zamora;30956;1513;9066;628;49275;40022;2141;4.8875823749838485;6.926979924994485;5.349557743241217;ZA
2020-06-16;Soria;23480;1854;7384;1116;42173;30864;2970;7.896081771720613;15.113759479956663;9.622861586314151;SO
2020-06-16;Valladolid;56348;2464;53944;4965;47186;110292;7429;4.372826009796267;9.20398932226012;6.735755993181735;VA
2020-06-17;Burgos;45105;2239;24800;1991;9059;69905;4230;4.963972952000887;8.028225806451612;6.051069308347042;BU
2020-06-17;Salamanca;38801;2807;24358;2988;37274;63159;5795;7.2343496301641705;12.267016996469332;9.175256099684923;SA
2020-06-17;Segovia;23939;2574;17835;2381;40004;41774;4955;10.752328835790967;13.350154191197083;11.861444917891511;SE
2020-06-17;Soria;23871;1873;7477;1119;42173;31348;2992;7.846340748188179;14.965895412598638;9.544468546637743;SO
2020-06-18;Soria;24062;1877;7533;1121;42173;31595;2998;7.800681572604105;14.88118943316076;9.48884317138788;SO
2020-06-18;Valladolid;58591;2522;55289;4979;47186;113880;7501;4.304415353893943;9.005407947331296;6.5867579908675795;VA
2020-06-19;León;47912;2662;36029;2630;24089;83941;5292;5.556019368842879;7.299675261594826;6.304428110220274;LE
2020-06-19;Valladolid;59298;2559;55832;4986;47186;115130;7545;4.315491247596884;8.93036251611979;6.553461304612178;VA
2020-06-19;Castilla y León;330295;18777;201535;19343;99999;531830;38120;5.684918027823612;9.59783660406381;7.167703965552902;CyL
2020-06-20;Burgos;45727;2254;25565;1997;9059;71292;4251;4.929254051217005;7.811460981811069;5.9628008752735235;BU
2020-06-20;León;47919;2663;36352;2630;24089;84271;5293;5.5572946013063715;7.23481514084507;6.280927009291452;LE
2020-06-21;Ávila;31321;1577;12258;1701;5019;43579;3278;5.034960569585901;13.876651982378855;7.52197159182175;AV
2020-06-21;Palencia;24933;821;12385;915;34120;37318;1736;3.2928247703846307;7.387969317723051;4.651910606141809;PA
2020-06-21;Segovia;24371;2599;18335;2382;40004;42706;4981;10.664314143859505;12.99154622307063;11.663466491827847;SE
2020-06-21;Soria;24360;1892;7723;1125;42173;32083;3017;7.766830870279145;14.566878156156934;9.403734064769505;SO
2020-06-21;Castilla y León;330826;18790;204460;19369;99999;535286;38159;5.67972287546928;9.473246600802113;7.128712501354416;CyL
2020-06-22;Ávila;31458;1582;12466;1703;5019;43924;3285;5.028927458834001;13.661158350713942;7.478827064930334;AV
2020-06-22;Soria;24415;1895;7811;1127;42173;32226;3022;7.761621953716976;14.428370247087441;9.377521256128592;SO
2020-06-22;Zamora;32548;1540;9750;629;49275;42298;2169;4.731473516037852;6.451282051282051;5.127902028464703;ZA
2020-03-13;Ávila;0;0;23;7;5019;23;7;;30.434782608695656;30.434782608695656;AV
2020-03-13;Palencia;0;0;2;0;34120;2;0;;0.0;0.0;PA
2020-03-13;Salamanca;0;0;65;18;37274;65;18;;27.692307692307693;27.692307692307693;SA
2020-03-13;Zamora;0;0;14;0;49275;14;0;;0.0;0.0;ZA
2020-03-14;Burgos;0;0;312;93;9059;312;93;;29.807692307692307;29.807692307692307;BU
2020-03-14;Palencia;0;0;2;0;34120;2;0;;0.0;0.0;PA
2020-03-14;Salamanca;0;0;106;33;37274;106;33;;31.132075471698112;31.132075471698112;SA
2020-03-14;Segovia;0;0;4;2;40004;4;2;;50.0;50.0;SE
2020-03-14;Soria;0;0;5;3;42173;5;3;;60.0;60.0;SO
2020-03-14;Valladolid;0;0;280;52;47186;280;52;;18.571428571428573;18.571428571428573;VA
2020-03-15;Burgos;0;0;345;99;9059;345;99;;28.695652173913043;28.695652173913043;BU
2020-03-15;Salamanca;0;0;178;55;37274;178;55;;30.89887640449438;30.89887640449438;SA
2020-03-15;Segovia;0;0;4;2;40004;4;2;;50.0;50.0;SE
2020-03-15;Soria;0;0;12;8;42173;12;8;;66.66666666666666;66.66666666666666;SO
2020-03-16;Castilla y León;0;0;1554;445;99999;1554;445;;28.635778635778635;28.635778635778635;CyL
2020-03-17;Burgos;0;0;436;138;9059;436;138;;31.65137614678899;31.65137614678899;BU
2020-03-17;Palencia;0;0;5;0;34120;5;0;;0.0;0.0;PA
2020-03-17;Segovia;0;0;82;49;40004;82;49;;59.756097560975604;59.756097560975604;SE
2020-03-17;Valladolid;0;0;680;136;47186;680;136;;20.0;20.0;VA
2020-03-18;Burgos;0;0;526;169;9059;526;169;;32.129277566539926;32.129277566539926;BU
2020-03-18;Valladolid;0;0;875;199;47186;875;199;;22.742857142857144;22.742857142857144;VA
2020-03-18;Zamora;0;0;126;23;49275;126;23;;18.253968253968253;18.253968253968253;ZA
2020-03-19;León;0;0;552;188;24089;552;188;;34.05797101449276;34.05797101449276;LE
2020-03-19;Segovia;0;0;235;135;40004;235;135;;57.446808510638306;57.446808510638306;SE
2020-03-19;Soria;0;0;115;82;42173;115;82;;71.30434782608695;71.30434782608695;SO
2020-03-19;Valladolid;0;0;1098;275;47186;1098;275;;25.045537340619305;25.045537340619305;VA
2020-03-20;Burgos;0;0;691;247;9059;691;247;;35.74529667149059;35.74529667149059;BU
2020-03-20;Palencia;0;0;19;2;34120;19;2;;10.526315789473683;10.526315789473683;PA
2020-03-20;Segovia;0;0;238;135;40004;238;135;;56.72268907563025;56.72268907563025;SE
2020-03-20;Valladolid;0;0;1334;348;47186;1334;348;;26.08695652173913;26.08695652173913;VA
2020-03-21;Burgos;0;0;779;282;9059;779;282;;36.2002567394095;36.2002567394095;BU
2020-03-23;Burgos;0;0;1018;393;9059;1018;393;;38.60510805500982;38.60510805500982;BU
2020-03-23;León;0;0;1090;431;24089;1090;431;;39.54128440366972;39.54128440366972;LE
2020-03-23;Salamanca;0;0;1123;512;37274;1123;512;;45.59216384683882;45.59216384683882;SA
2020-03-24;Ávila;0;0;491;268;5019;491;268;;54.58248472505092;54.58248472505092;AV
2020-03-24;Palencia;0;0;31;3;34120;31;3;;9.67741935483871;9.67741935483871;PA
2020-03-24;Salamanca;0;0;1270;571;37274;1270;571;;44.960629921259844;44.960629921259844;SA
2020-03-25;León;0;0;1394;593;24089;1394;593;;42.53945480631277;42.53945480631277;LE
2020-03-25;Palencia;0;0;33;3;34120;33;3;;9.090909090909092;9.090909090909092;PA
2020-03-25;Salamanca;0;0;1627;747;37274;1627;747;;45.912722802704366;45.912722802704366;SA
2020-03-26;Ávila;0;0;792;430;5019;792;430;;54.292929292929294;54.292929292929294;AV
2020-03-26;León;0;0;1653;701;24089;1653;701;;42.407743496672715;42.407743496672715;LE
2020-03-27;León;0;0;1909;836;24089;1909;836;;43.792561550550026;43.792561550550026;LE
2020-03-27;Valladolid;0;0;3248;1217;47186;3248;1217;;37.4692118226601;37.4692118226601;VA
2020-03-27;Zamora;0;0;552;171;49275;552;171;;30.978260869565215;30.978260869565215;ZA
2020-03-28;León;0;0;2136;946;24089;2136;946;;44.28838951310862;44.28838951310862;LE
2020-03-28;Palencia;0;0;155;57;34120;155;57;;36.774193548387096;36.774193548387096;PA
2020-03-28;Salamanca;0;0;2451;1126;37274;2451;1126;;45.94043247654019;45.94043247654019;SA
2020-03-28;Soria;0;0;742;502;42173;742;502;;67.65498652291106;67.65498652291106;SO
2020-03-28;Zamora;0;0;612;189;49275;612;189;;30.88235294117647;30.88235294117647;ZA
2020-03-28;Castilla y León;0;0;13858;6284;99999;13858;6284;;45.34564872275942;45.34564872275942;CyL
2020-03-29;Ávila;0;0;1048;560;5019;1048;560;;53.43511450381679;53.43511450381679;AV
2020-03-29;Palencia;0;0;216;85;34120;216;85;;39.351851851851855;39.351851851851855;PA
2020-03-29;Salamanca;0;0;2606;1169;37274;2606;1169;;44.858019953952414;44.858019953952414;SA
2020-03-29;Soria;0;0;796;530;42173;796;530;;66.58291457286433;66.58291457286433;SO
2020-03-29;Zamora;0;0;646;200;49275;646;200;;30.959752321981426;30.959752321981426;ZA
2020-03-30;Salamanca;0;0;2994;1335;37274;2994;1335;;44.589178356713425;44.589178356713425;SA
2020-03-30;Zamora;0;0;685;210;49275;685;210;;30.656934306569344;30.656934306569344;ZA
2020-03-31;Burgos;0;0;2130;833;9059;2130;833;;39.10798122065728;39.10798122065728;BU
2020-03-31;Zamora;0;0;712;213;49275;712;213;;29.91573033707865;29.91573033707865;ZA
2020-03-31;Castilla y León;0;0;17590;7724;99999;17590;7724;;43.91131324616259;43.91131324616259;CyL
2020-04-01;Ávila;24;2;1447;783;5019;1471;785;8.333333333333332;54.11195577055978;53.36505778382053;AV
2020-04-01;Burgos;0;0;2338;886;9059;2338;886;;37.8956372968349;37.8956372968349;BU
2020-04-01;Palencia;0;0;421;161;34120;421;161;;38.242280285035626;38.242280285035626;PA
2020-04-01;Salamanca;2;0;3717;1550;37274;3719;1550;0.0;41.70029593758407;41.67787039526755;SA
2020-04-01;Segovia;0;0;2310;1263;40004;2310;1263;;54.675324675324674;54.675324675324674;SE
2020-04-01;Soria;0;0;1078;671;42173;1078;671;;62.244897959183675;62.244897959183675;SO
2020-04-01;Valladolid;0;0;4711;1670;47186;4711;1670;;35.44894926767141;35.44894926767141;VA
2020-04-02;Burgos;0;0;2546;930;9059;2546;930;;36.52788688138256;36.52788688138256;BU
2020-04-02;Salamanca;4;1;4096;1661;37274;4100;1662;25.0;40.5517578125;40.53658536585366;SA
2020-04-02;Segovia;0;0;2478;1337;40004;2478;1337;;53.954802259887;53.954802259887;SE
2020-04-02;Soria;0;0;1201;737;42173;1201;737;;61.36552872606161;61.36552872606161;SO
2020-04-02;Valladolid;0;0;5125;1806;47186;5125;1806;;35.2390243902439;35.2390243902439;VA
2020-04-02;Zamora;0;0;851;226;49275;851;226;;26.556991774383075;26.556991774383075;ZA
2020-04-03;Palencia;0;0;613;216;34120;613;216;;35.23654159869494;35.23654159869494;PA
2020-04-04;León;2;0;3602;1351;24089;3604;1351;0.0;37.50694058856191;37.48612652608213;LE
2020-04-04;Palencia;0;0;683;242;34120;683;242;;35.43191800878478;35.43191800878478;PA
2020-04-04;Zamora;39;3;1041;244;49275;1080;247;7.6923076923076925;23.439000960614795;22.87037037037037;ZA
2020-04-05;Burgos;0;0;2954;990;9059;2954;990;;33.51387948544347;33.51387948544347;BU
2020-04-05;León;2;0;3842;1400;24089;3844;1400;0.0;36.43935450286309;36.420395421436005;LE
2020-04-05;Salamanca;8;1;4994;1993;37274;5002;1994;12.5;39.90788946736083;39.864054378248696;SA
2020-04-05;Segovia;1;0;3101;1632;40004;3102;1632;0.0;52.62818445662689;52.61121856866537;SE
2020-04-05;Zamora;41;3;1079;249;49275;1120;252;7.317073170731707;23.076923076923077;22.5;ZA
2020-04-06;Burgos;18;4;3095;1009;9059;3113;1013;22.22222222222222;32.600969305331176;32.54095727593961;BU
2020-04-06;León;12;3;4006;1432;24089;4018;1435;25.0;35.746380429355966;35.714285714285715;LE
2020-04-06;Palencia;0;0;806;279;34120;806;279;;34.61538461538461;34.61538461538461;PA
2020-04-06;Segovia;3;1;3248;1684;40004;3251;1685;33.33333333333333;51.847290640394085;51.83020609043372;SE
2020-04-07;Burgos;28;8;3294;1039;9059;3322;1047;28.57142857142857;31.54219793564056;31.51715833835039;BU
2020-04-07;León;100;6;4289;1494;24089;4389;1500;6.0;34.83329447423642;34.17634996582365;LE
2020-04-07;Salamanca;80;4;5504;2122;37274;5584;2126;5.0;38.553779069767444;38.0730659025788;SA
2020-04-08;Burgos;92;14;3434;1066;9059;3526;1080;15.217391304347828;31.042516016307513;30.629608621667614;BU
2020-04-08;León;123;10;4531;1544;24089;4654;1554;8.130081300813007;34.076362833811515;33.39063171465406;LE
2020-04-08;Salamanca;120;7;5740;2202;37274;5860;2209;5.833333333333333;38.362369337979096;37.696245733788395;SA
2020-04-08;Zamora;143;15;1254;266;49275;1397;281;10.48951048951049;21.21212121212121;20.114531138153186;ZA
2020-04-08;Castilla y León;1219;112;32384;12109;99999;33603;12221;9.187858900738311;37.39192193675889;36.36877659732762;CyL
2020-04-09;Salamanca;143;7;5998;2246;37274;6141;2253;4.895104895104895;37.445815271757255;36.687835857352226;SA
2020-04-09;Castilla y León;2384;254;34711;12561;99999;37095;12815;10.654362416107382;36.18737575984558;34.546434829491844;CyL
2020-04-10;Palencia;167;38;1178;372;34120;1345;410;22.75449101796407;31.57894736842105;30.483271375464682;PA
2020-04-10;Zamora;192;21;1421;281;49275;1613;302;10.9375;19.774806474313863;18.722876627402353;ZA
2020-04-11;Soria;520;88;1792;903;42173;2312;991;16.923076923076923;50.390625;42.863321799307954;SO
2020-04-11;Castilla y León;6293;758;38951;13489;99999;45244;14247;12.04512950897823;34.630689841082386;31.489258244187074;CyL
2020-04-12;Palencia;318;48;1341;399;34120;1659;447;15.09433962264151;29.753914988814316;26.94394213381555;PA
2020-04-12;Salamanca;252;27;6604;2383;37274;6856;2410;10.714285714285714;36.084191399152026;35.15169194865811;SA
2020-04-12;Zamora;223;21;1601;287;49275;1824;308;9.417040358744394;17.926296064959402;16.885964912280702;ZA
2020-04-13;Palencia;463;58;1396;407;34120;1859;465;12.526997840172784;29.15472779369627;25.013448090371167;PA
2020-04-13;Segovia;250;55;4195;1793;40004;4445;1848;22.0;42.74135876042908;41.574803149606296;SE
2020-04-13;Valladolid;941;47;13833;4086;47186;14774;4133;4.994686503719448;29.53806115810019;27.97482063083796;VA
2020-04-13;Zamora;235;22;1630;293;49275;1865;315;9.361702127659575;17.975460122699385;16.890080428954423;ZA
2020-04-13;Castilla y León;9723;1032;42896;14260;99999;52619;15292;10.614008022215366;33.2431928384931;29.06174575723598;CyL
2020-04-14;Valladolid;1662;61;14957;4191;47186;16619;4252;3.6702767749699152;28.020324931470213;25.585173596485948;VA
2020-04-14;Zamora;312;31;1726;297;49275;2038;328;9.935897435897436;17.207415990730013;16.09421000981354;ZA
2020-04-15;Ávila;2473;251;3017;1346;5019;5490;1597;10.149615851192884;44.61385482267153;29.089253187613846;AV
2020-04-15;León;5626;429;6847;1893;24089;12473;2322;7.6253110558123005;27.647144734920403;18.616211015794114;LE
2020-04-15;Palencia;1253;109;1520;419;34120;2773;528;8.699122106943335;27.56578947368421;19.04075009015507;PA
2020-04-15;Segovia;410;94;4672;1828;40004;5082;1922;22.926829268292686;39.12671232876712;37.819756001574184;SE
2020-04-16;Burgos;5103;527;5150;1436;9059;10253;1963;10.327258475406625;27.883495145631066;19.1456159172925;BU
2020-04-16;León;6495;477;7171;1916;24089;13666;2393;7.344110854503465;26.718728210849253;17.510610273671887;LE
2020-04-16;Palencia;1858;135;1550;419;34120;3408;554;7.265877287405813;27.032258064516128;16.255868544600936;PA
2020-04-17;Ávila;3403;305;3270;1392;5019;6673;1697;8.962679988245666;42.56880733944954;25.430840701333736;AV
2020-04-17;León;7984;553;7710;1954;24089;15694;2507;6.926352705410823;25.343709468223086;15.97425767809354;LE
2020-04-17;Castilla y León;28040;2361;52224;15318;99999;80264;17679;8.420114122681884;29.331341911764707;22.02606398883684;CyL
2020-04-18;Ávila;3617;320;3347;1408;5019;6964;1728;8.847110865358033;42.06752315506424;24.813325674899485;AV
2020-04-18;Soria;2109;286;2135;943;42173;4244;1229;13.560929350403034;44.16861826697892;28.958529688972668;SO
2020-04-18;Castilla y León;29618;2480;53403;15428;99999;83021;17908;8.37328651495712;28.889762747411197;21.570446031726913;CyL
2020-04-19;Palencia;2597;146;1666;433;34120;4263;579;5.62187139006546;25.990396158463387;13.58198451794511;PA
2020-04-19;Soria;2478;388;2222;945;42173;4700;1333;15.657788539144471;42.529252925292525;28.361702127659576;SO
2020-04-20;Ávila;3870;352;3569;1448;5019;7439;1800;9.095607235142118;40.571588680302604;24.196800645248018;AV
2020-04-20;Salamanca;1507;334;8257;2630;37274;9764;2964;22.16323822163238;31.851762141213513;30.35641130684146;SA
2020-04-20;Castilla y León;34931;3042;57380;15706;99999;92311;18748;8.708596948269445;27.371906587661204;20.30960557246699;CyL
2020-04-21;Soria;3138;544;2320;953;42173;5458;1497;17.335882727852134;41.07758620689655;27.42762916819348;SO
2020-04-21;Zamora;929;90;2222;327;49275;3151;417;9.68783638320775;14.716471647164717;13.233894001904156;ZA
2020-04-22;Ávila;4131;368;3829;1466;5019;7960;1834;8.908254659888646;38.28675894489423;23.040201005025125;AV
2020-04-22;Palencia;4184;189;1877;448;34120;6061;637;4.517208413001912;23.867874267448055;10.509816861903975;PA
2020-04-22;Salamanca;1972;448;8897;2696;37274;10869;3144;22.718052738336713;30.302349106440374;28.926304167816724;SA
2020-04-22;Valladolid;5562;145;22359;4706;47186;27921;4851;2.6069759079467816;21.047452927232882;17.374019555173525;VA
2020-04-22;Zamora;1152;109;2368;335;49275;3520;444;9.461805555555555;14.14695945945946;12.613636363636363;ZA
2020-04-23;Palencia;4388;192;1992;458;34120;6380;650;4.375569735642662;22.991967871485944;10.18808777429467;PA
2020-04-23;Soria;4152;631;2421;959;42173;6573;1590;15.197495183044316;39.611730689797604;24.189867640346876;SO
2020-04-24;Valladolid;6336;158;24696;4803;47186;31032;4961;2.493686868686869;19.44849368318756;15.986723382315029;VA
2020-04-24;Zamora;1616;155;2578;339;49275;4194;494;9.591584158415841;13.149728471683474;11.778731521220791;ZA
2020-04-25;León;12284;855;11406;2293;24089;23690;3148;6.960273526538587;20.103454322286517;13.28830730265935;LE
2020-04-25;Soria;4931;673;2586;968;42173;7517;1641;13.648347191239099;37.4323279195669;21.83051749368099;SO
2020-04-26;Soria;5311;719;2660;976;42173;7971;1695;13.537940124270381;36.69172932330827;21.264584117425667;SO
2020-04-26;Valladolid;6513;172;26000;4837;47186;32513;5009;2.6408721019499466;18.603846153846153;15.406145234214005;VA
2020-04-27;Ávila;4610;395;4730;1549;5019;9340;1944;8.568329718004339;32.74841437632136;20.813704496788006;AV
2020-04-27;León;12979;870;12067;2323;24089;25046;3193;6.7031358348100785;19.25084942404906;12.748542681466102;LE
2020-04-27;Valladolid;6965;178;28410;4992;47186;35375;5170;2.555635319454415;17.571277719112988;14.614840989399294;VA
2020-04-28;Salamanca;2889;583;10266;2719;37274;13155;3302;20.17999307718934;26.48548607052406;25.100722158874955;SA
2020-04-29;Burgos;11544;689;8305;1739;9059;19849;2428;5.968468468468469;20.939193257074052;12.232354274774549;BU
2020-04-29;Castilla y León;61384;4771;83427;17365;99999;144811;22136;7.772383683044441;20.81460438467163;15.286131578402193;CyL
2020-04-30;León;15070;933;13573;2384;24089;28643;3317;6.191108161911082;17.564282030501733;11.580490870369724;LE
2020-04-30;Soria;6796;816;2909;977;42173;9705;1793;12.007062978222484;33.58542454451702;18.475012879958786;SO
2020-04-30;Zamora;3917;327;3675;547;49275;7592;874;8.348225682920603;14.884353741496598;11.512118018967334;ZA
2020-05-01;Ávila;6220;449;5246;1575;5019;11466;2024;7.218649517684887;30.02287457110179;17.652189080760508;AV
2020-05-01;Burgos;12156;708;8979;1774;9059;21135;2482;5.824284304047384;19.757211270742843;11.743553347527797;BU
2020-05-01;Segovia;4127;697;9063;2287;40004;13190;2984;16.888781196995396;25.234469822354626;22.623199393479908;SE
2020-05-01;Soria;7110;845;2980;977;42173;10090;1822;11.884669479606188;32.785234899328856;18.057482656095143;SO
2020-05-01;Zamora;4259;346;3719;548;49275;7978;894;8.123972763559522;14.735143855875235;11.205815993983455;ZA
2020-05-01;Castilla y León;68642;5107;89014;17583;99999;157656;22690;7.4400512805570935;19.753072550385333;14.392094179733089;CyL
2020-05-02;Segovia;4331;711;9204;2289;40004;13535;3000;16.416531978757792;24.86962190352021;22.164758034724787;SE
2020-05-02;Castilla y León;71319;5261;90693;17629;99999;162012;22890;7.376715882163238;19.43810437409723;14.128583067920895;CyL
2020-05-03;Palencia;5864;236;4488;770;34120;10352;1006;4.024556616643929;17.15686274509804;9.717928902627511;PA
2020-05-03;Salamanca;6188;731;11446;2760;37274;17634;3491;11.813186813186812;24.113227328324307;19.796983100827948;SA
2020-05-03;Valladolid;9046;232;30124;4511;47186;39170;4743;2.5646694671678087;14.974770946753418;12.108756701557315;VA
2020-05-04;Zamora;5596;408;3958;550;49275;9554;958;7.290922087205147;13.895907023749368;10.027213732468077;ZA
2020-05-05;León;16904;1017;15099;2450;24089;32003;3467;6.016327496450544;16.226240148354197;10.833359372558823;LE
2020-05-05;Valladolid;13508;324;32092;4572;47186;45600;4896;2.398578620076991;14.246541194067058;10.73684210526316;VA
2020-05-06;Ávila;8265;561;5977;1598;5019;14242;2159;6.787658802177858;26.735820645808932;15.159387726442915;AV
2020-05-07;Valladolid;19219;508;33923;4645;47186;53142;5153;2.6432176492013113;13.692774813548331;9.696661774114636;VA
2020-05-09;Ávila;10127;666;6386;1617;5019;16513;2283;6.576478720252791;25.321014719699342;13.825470841155454;AV
2020-05-09;Segovia;8311;1042;10552;2304;40004;18863;3346;12.53760077006377;21.834723275208493;17.73842973015957;SE
2020-05-09;Zamora;10688;802;4533;565;49275;15221;1367;7.50374251497006;12.464151775865872;8.981013074042442;ZA
2020-05-10;Burgos;17812;892;10742;1840;9059;28554;2732;5.00785986975073;17.129026252094583;9.567836380191917;BU
2020-05-10;Salamanca;14885;1229;13417;2794;37274;28302;4023;8.256634195498824;20.82432734590445;14.214543141827432;SA
2020-05-10;Valladolid;22282;582;35238;4683;47186;57520;5265;2.611973790503545;13.289630512514899;9.153337969401946;VA
2020-05-11;León;20038;1216;17137;2501;24089;37175;3717;6.0684699071763655;14.594153002275778;9.998655010087425;LE
2020-05-11;Palencia;10187;340;5632;794;34120;15819;1134;3.3375871208402867;14.098011363636365;7.168594727858904;PA
2020-05-11;Zamora;11360;835;4781;592;49275;16141;1427;7.350352112676056;12.382346789374608;8.840840096648286;ZA
2020-05-12;Salamanca;16946;1402;13959;2799;37274;30905;4201;8.27333884102443;20.05157962604771;13.59326969745996;SA
2020-05-12;Zamora;12174;894;4945;593;49275;17119;1487;7.343518974864466;11.991911021233568;8.686255038261582;ZA
2020-05-13;Ávila;12606;778;6788;1607;5019;19394;2385;6.171664286847533;23.674130819092515;12.297617819944312;AV
2020-05-14;Segovia;11996;1348;11652;2321;40004;23648;3669;11.237079026342114;19.919327154136628;15.515054127198919;SE
2020-05-14;Soria;14239;1381;4047;1004;42173;18286;2385;9.698714797387458;24.808500123548306;13.042764956797551;SO
2020-05-14;Zamora;14907;1021;5283;599;49275;20190;1620;6.849131280606427;11.338254779481355;8.023774145616642;ZA
2020-05-17;Burgos;26393;1339;12720;1878;9059;39113;3217;5.073314894100708;14.764150943396226;8.2248868662593;BU
2020-05-17;Segovia;13057;1499;12270;2333;40004;25327;3832;11.480431952209543;19.013854930725348;15.130098314052198;SE
2020-05-18;Castilla y León;184630;11596;125048;18447;99999;309678;30043;6.280669447002113;14.751935256861366;9.701367226603116;CyL
2020-05-19;Palencia;14811;460;6811;832;34120;21622;1292;3.105799743433934;12.215533695492585;5.975395430579964;PA
2020-05-19;Soria;15463;1479;4554;1016;42173;20017;2495;9.5647675095389;22.31005709266579;12.464405255532798;SO
2020-05-23;León;30994;1934;23325;2574;24089;54319;4508;6.239917403368394;11.035369774919614;8.299121854231483;LE
2020-05-23;Valladolid;38878;1612;42024;4829;47186;80902;6441;4.146303822213077;11.49105273177232;7.961484264913104;VA
2020-05-23;Zamora;25107;1346;6533;612;49275;31640;1958;5.361054685944159;9.36782488902495;6.188369152970923;ZA
2020-05-24;Zamora;25112;1347;6599;612;49275;31711;1959;5.363969417011787;9.274132444309743;6.17766705559585;ZA
2020-05-25;Burgos;33641;1765;15305;1911;9059;48946;3676;5.246574120864421;12.486115648480888;7.5103174927471095;BU
2020-05-26;Segovia;18983;2199;14158;2352;40004;33141;4551;11.58404888584523;16.61251589207515;13.732234995926495;SE
2020-05-26;Soria;17749;1588;5200;1039;42173;22949;2627;8.946982928615697;19.98076923076923;11.447121878948973;SO
2020-05-28;Ávila;24290;1340;8707;1649;5019;32997;2989;5.516673528200906;18.93878488572413;9.058399248416523;AV
2020-05-29;Palencia;20429;653;8417;859;34120;28846;1512;3.1964364383963972;10.205536414399429;5.241627955349095;PA
2020-05-31;Burgos;38386;1954;17678;1943;9059;56064;3897;5.090397540770073;10.991062337368481;6.950984589041095;BU
2020-05-31;León;36371;2164;26607;2602;24089;62978;4766;5.949795166478788;9.77938136580599;7.56772206167233;LE
2020-06-01;Zamora;27820;1441;7595;617;49275;35415;2058;5.179726815240834;8.123765635286373;5.811096992799661;ZA
2020-06-02;Ávila;25753;1409;9441;1674;5019;35194;3083;5.47120723799169;17.731172545281222;8.760015911803148;AV
2020-06-02;Valladolid;47373;2042;46736;4893;47186;94109;6935;4.310472209908598;10.46944539541253;7.369114537398123;VA
2020-06-04;Burgos;40740;2087;19796;1967;9059;60536;4054;5.122729504172803;9.936350777934937;6.696841548830449;BU
2020-06-04;Soria;20598;1743;6245;1083;42173;26843;2826;8.46198660064084;17.34187349879904;10.527884364638826;SO
2020-06-04;Zamora;29062;1457;7921;618;49275;36983;2075;5.013419585713303;7.802045196313596;5.610685990860666;ZA
2020-06-04;Castilla y León;282133;16848;167186;19019;99999;449319;35867;5.97165166783042;11.375952531910567;7.982524665104303;CyL
2020-06-05;Zamora;29321;1467;8061;620;49275;37382;2087;5.003239998635791;7.691353430095521;5.582900861377134;ZA
2020-06-06;Palencia;21634;721;9925;882;34120;31559;1603;3.3327170195063323;8.886649874055417;5.079375138629234;PA
2020-06-06;Segovia;21567;2467;16178;2361;40004;37745;4828;11.43877219826587;14.593892941031031;12.791098158696515;SE
2020-06-06;Zamora;29328;1468;8228;621;49275;37556;2089;5.005455537370431;7.547399124939232;5.562360208754926;ZA
2020-06-07;Burgos;41332;2123;21009;1978;9059;62341;4101;5.136456014710152;9.415012613641773;6.57833528496495;BU
2020-06-07;Castilla y León;288598;17178;173913;19103;99999;462511;36281;5.952224201137915;10.984227746056936;7.844353972121744;CyL
2020-03-13;Burgos;0;0;258;76;9059;258;76;;29.457364341085274;29.457364341085274;BU
2020-03-13;León;0;0;92;30;24089;92;30;;32.608695652173914;32.608695652173914;LE
2020-03-13;Segovia;0;0;1;1;40004;1;1;;100.0;100.0;SE
2020-03-13;Valladolid;0;0;201;31;47186;201;31;;15.422885572139302;15.422885572139302;VA
2020-03-13;Castilla y León;0;0;658;164;99999;658;164;;24.924012158054712;24.924012158054712;CyL
2020-03-14;Ávila;0;0;25;8;5019;25;8;;32.0;32.0;AV
2020-03-14;Zamora;0;0;18;0;49275;18;0;;0.0;0.0;ZA
2020-03-14;Castilla y León;0;0;900;234;99999;900;234;;26.0;26.0;CyL
2020-03-15;Ávila;0;0;56;23;5019;56;23;;41.07142857142857;41.07142857142857;AV
2020-03-15;Valladolid;0;0;400;80;47186;400;80;;20.0;20.0;VA
2020-03-15;Zamora;0;0;20;0;49275;20;0;;0.0;0.0;ZA
2020-03-15;Castilla y León;0;0;1210;330;99999;1210;330;;27.27272727272727;27.27272727272727;CyL
2020-03-16;León;0;0;258;91;24089;258;91;;35.27131782945737;35.27131782945737;LE
2020-03-16;Palencia;0;0;5;0;34120;5;0;;0.0;0.0;PA
2020-03-16;Segovia;0;0;18;10;40004;18;10;;55.55555555555556;55.55555555555556;SE
2020-03-16;Valladolid;0;0;507;102;47186;507;102;;20.118343195266274;20.118343195266274;VA
2020-03-17;Ávila;0;0;128;53;5019;128;53;;41.40625;41.40625;AV
2020-03-17;Castilla y León;0;0;2165;680;99999;2165;680;;31.40877598152425;31.40877598152425;CyL
2020-03-18;Salamanca;0;0;444;168;37274;444;168;;37.83783783783784;37.83783783783784;SA
2020-03-18;Soria;0;0;109;78;42173;109;78;;71.55963302752293;71.55963302752293;SO
2020-03-18;Castilla y León;0;0;2868;965;99999;2868;965;;33.64714086471409;33.64714086471409;CyL
2020-03-19;Ávila;0;0;196;99;5019;196;99;;50.51020408163265;50.51020408163265;AV
2020-03-19;Salamanca;0;0;547;221;37274;547;221;;40.40219378427788;40.40219378427788;SA
2020-03-19;Zamora;0;0;158;36;49275;158;36;;22.78481012658228;22.78481012658228;ZA
2020-03-19;Castilla y León;0;0;3514;1236;99999;3514;1236;;35.173591348890156;35.173591348890156;CyL
2020-03-21;Ávila;0;0;284;150;5019;284;150;;52.816901408450704;52.816901408450704;AV
2020-03-21;Segovia;0;0;314;186;40004;314;186;;59.23566878980891;59.23566878980891;SE
2020-03-21;Zamora;0;0;227;60;49275;227;60;;26.431718061674008;26.431718061674008;ZA
2020-03-22;Ávila;0;0;296;158;5019;296;158;;53.37837837837838;53.37837837837838;AV
2020-03-22;Burgos;0;0;859;326;9059;859;326;;37.951105937136205;37.951105937136205;BU
2020-03-22;León;0;0;908;359;24089;908;359;;39.53744493392071;39.53744493392071;LE
2020-03-22;Palencia;0;0;22;3;34120;22;3;;13.636363636363635;13.636363636363635;PA
2020-03-22;Segovia;0;0;375;237;40004;375;237;;63.2;63.2;SE
2020-03-22;Soria;0;0;189;135;42173;189;135;;71.42857142857143;71.42857142857143;SO
2020-03-22;Valladolid;0;0;1643;488;47186;1643;488;;29.701765063907487;29.701765063907487;VA
2020-03-22;Zamora;0;0;276;78;49275;276;78;;28.26086956521739;28.26086956521739;ZA
2020-03-22;Castilla y León;0;0;5525;2236;99999;5525;2236;;40.470588235294116;40.470588235294116;CyL
2020-03-23;Segovia;0;0;521;287;40004;521;287;;55.08637236084453;55.08637236084453;SE
2020-03-23;Soria;0;0;250;174;42173;250;174;;69.6;69.6;SO
2020-03-23;Castilla y León;0;0;6635;2696;99999;6635;2696;;40.633006782215524;40.633006782215524;CyL
2020-03-24;Burgos;0;0;1176;471;9059;1176;471;;40.05102040816326;40.05102040816326;BU
2020-03-24;Zamora;0;0;319;91;49275;319;91;;28.526645768025077;28.526645768025077;ZA
2020-03-24;Castilla y León;0;0;7762;3285;99999;7762;3285;;42.3215666065447;42.3215666065447;CyL
2020-03-25;Ávila;0;0;592;318;5019;592;318;;53.71621621621622;53.71621621621622;AV
2020-03-26;Palencia;0;0;36;5;34120;36;5;;13.88888888888889;13.88888888888889;PA
2020-03-27;Segovia;0;0;1313;789;40004;1313;789;;60.09139375476009;60.09139375476009;SE
2020-03-27;Castilla y León;0;0;12428;5638;99999;12428;5638;;45.36530415191503;45.36530415191503;CyL
2020-03-28;Burgos;0;0;1723;710;9059;1723;710;;41.2071967498549;41.2071967498549;BU
2020-03-29;Valladolid;0;0;3708;1361;47186;3708;1361;;36.704422869471415;36.704422869471415;VA
2020-03-29;Castilla y León;0;0;14866;6694;99999;14866;6694;;45.02892506390421;45.02892506390421;CyL
2020-03-30;Burgos;0;0;1960;782;9059;1960;782;;39.89795918367347;39.89795918367347;BU
2020-03-30;Soria;0;0;800;534;42173;800;534;;66.75;66.75;SO
2020-03-30;Valladolid;0;0;3991;1453;47186;3991;1453;;36.40691556001002;36.40691556001002;VA
2020-03-30;Castilla y León;0;0;16019;7131;99999;16019;7131;;44.515887383731815;44.515887383731815;CyL
2020-03-31;Salamanca;0;0;3361;1440;37274;3361;1440;;42.844391550133885;42.844391550133885;SA
2020-04-01;León;0;0;2866;1176;24089;2866;1176;;41.032798325191905;41.032798325191905;LE
2020-04-03;Ávila;68;9;1729;932;5019;1797;941;13.23529411764706;53.90399074609601;52.3650528658876;AV
2020-04-03;Soria;0;0;1229;748;42173;1229;748;;60.86248982912937;60.86248982912937;SO
2020-04-03;Zamora;0;0;968;237;49275;968;237;;24.483471074380166;24.483471074380166;ZA
2020-04-03;Castilla y León;74;10;23517;9617;99999;23591;9627;13.513513513513514;40.893821490836416;40.80793522953669;CyL
2020-04-04;Ávila;72;9;1842;989;5019;1914;998;12.5;53.69163952225841;52.14211076280042;AV
2020-04-04;Salamanca;8;1;4703;1851;37274;4711;1852;12.5;39.357856687220924;39.31224793037572;SA
2020-04-04;Valladolid;0;0;6406;2238;47186;6406;2238;;34.93599750234155;34.93599750234155;VA
2020-04-05;Ávila;72;9;1922;1022;5019;1994;1031;12.5;53.17377731529657;51.70511534603811;AV
2020-04-05;Soria;0;0;1375;807;42173;1375;807;;58.690909090909095;58.690909090909095;SO
2020-04-05;Valladolid;0;0;6713;2345;47186;6713;2345;;34.932221063607926;34.932221063607926;VA
2020-04-05;Castilla y León;124;13;26728;10695;99999;26852;10708;10.483870967741936;40.01421730020952;39.8778489497989;CyL
2020-04-06;Salamanca;28;2;5212;2040;37274;5240;2042;7.142857142857142;39.14044512663085;38.969465648854964;SA
2020-04-06;Soria;8;3;1397;812;42173;1405;815;37.5;58.12455261274159;58.00711743772242;SO
2020-04-06;Zamora;64;5;1150;252;49275;1214;257;7.8125;21.913043478260867;21.16968698517298;ZA
2020-04-07;Ávila;132;16;2204;1138;5019;2336;1154;12.121212121212121;51.633393829401086;49.40068493150685;AV
2020-04-07;Soria;18;5;1428;818;42173;1446;823;27.77777777777778;57.2829131652661;56.91562932226832;SO
2020-04-07;Valladolid;11;1;8001;2644;47186;8012;2645;9.090909090909092;33.04586926634171;33.012980529206196;VA
2020-04-07;Zamora;95;10;1200;256;49275;1295;266;10.526315789473683;21.333333333333336;20.54054054054054;ZA
2020-04-07;Castilla y León;471;53;30214;11520;99999;30685;11573;11.252653927813164;38.12802012312173;37.71549617076747;CyL
2020-04-08;Palencia;4;0;1001;317;34120;1005;317;0.0;31.668331668331668;31.542288557213933;PA
2020-04-08;Segovia;24;9;3475;1723;40004;3499;1732;37.5;49.58273381294964;49.49985710202915;SE
2020-04-08;Soria;49;11;1592;854;42173;1641;865;22.448979591836736;53.64321608040201;52.71176112126752;SO
2020-04-09;León;482;33;4801;1593;24089;5283;1626;6.846473029045644;33.180587377629664;30.777967064168088;LE
2020-04-09;Soria;183;30;1675;871;42173;1858;901;16.39344262295082;52.0;48.4930032292788;SO
2020-04-10;Ávila;999;134;2629;1237;5019;3628;1371;13.413413413413414;47.052111068847466;37.78941565600882;AV
2020-04-10;Burgos;644;129;3854;1165;9059;4498;1294;20.031055900621116;30.2283341982356;28.768341485104493;BU
2020-04-10;León;2175;203;5309;1635;24089;7484;1838;9.333333333333334;30.796760218496892;24.559059326563336;LE
2020-04-10;Salamanca;216;25;6294;2318;37274;6510;2343;11.574074074074074;36.82872577057515;35.99078341013825;SA
2020-04-10;Soria;441;75;1731;887;42173;2172;962;17.006802721088434;51.2420566146736;44.29097605893186;SO
2020-04-11;Ávila;1140;136;2661;1244;5019;3801;1380;11.929824561403509;46.74934235249906;36.30623520126283;AV
2020-04-11;Salamanca;233;27;6505;2372;37274;6738;2399;11.587982832618025;36.46425826287471;35.60403680617394;SA
2020-04-11;Zamora;214;21;1450;284;49275;1664;305;9.813084112149532;19.586206896551726;18.329326923076923;ZA
2020-04-12;Burgos;1073;184;4199;1230;9059;5272;1414;17.148182665424045;29.29268873541319;26.820940819423367;BU
2020-04-12;León;2506;222;5551;1689;24089;8057;1911;8.85873902633679;30.426950099081246;23.71850564726325;LE
2020-04-12;Castilla y León;7112;830;40705;13906;99999;47817;14736;11.670416197975253;34.162879253163005;30.817491687056904;CyL
2020-04-13;Ávila;1545;173;2804;1296;5019;4349;1469;11.197411003236246;46.219686162624825;33.77787997240745;AV
2020-04-13;León;3486;284;6018;1807;24089;9504;2091;8.14687320711417;30.02658690594882;22.001262626262626;LE
2020-04-13;Salamanca;409;47;6830;2417;37274;7239;2464;11.491442542787286;35.387994143484626;34.037850531841414;SA
2020-04-13;Soria;857;147;1887;918;42173;2744;1065;17.152858809801632;48.64864864864865;38.81195335276968;SO
2020-04-14;Burgos;2378;357;4546;1289;9059;6924;1646;15.012615643397814;28.3545974483062;23.772385904101675;BU
2020-04-14;León;4643;326;6518;1858;24089;11161;2184;7.0213224208485885;28.5056765879104;19.568139055640177;LE
2020-04-14;Palencia;810;74;1442;412;34120;2252;486;9.135802469135802;28.57142857142857;21.58081705150977;PA
2020-04-15;Burgos;3537;447;4871;1361;9059;8408;1808;12.637828668363019;27.94087456374461;21.503330161750714;BU
2020-04-15;Soria;1363;226;1977;928;42173;3340;1154;16.581071166544387;46.93980778958017;34.550898203592816;SO
2020-04-15;Zamora;407;42;1788;300;49275;2195;342;10.319410319410318;16.778523489932887;15.580865603644648;ZA
2020-04-16;Ávila;3058;274;3127;1366;5019;6185;1640;8.960104643557882;43.68404221298369;26.515763945028294;AV
2020-04-16;Segovia;455;104;4834;1841;40004;5289;1945;22.857142857142858;38.08440215142739;36.77443751181698;SE
2020-04-16;Valladolid;2980;69;16878;4340;47186;19858;4409;2.315436241610738;25.713947150136274;22.20263873501863;VA
2020-04-16;Zamora;550;53;1896;310;49275;2446;363;9.636363636363637;16.350210970464136;14.840556009811937;ZA
2020-04-17;Palencia;2346;144;1595;424;34120;3941;568;6.138107416879795;26.583072100313483;14.412585638162904;PA
2020-04-17;Salamanca;1031;226;7744;2595;37274;8775;2821;21.92046556741028;33.50981404958678;32.148148148148145;SA
2020-04-17;Segovia;614;127;5024;1845;40004;5638;1972;20.684039087947884;36.72372611464968;34.97694217807733;SE
2020-04-18;Burgos;6961;591;5538;1485;9059;12499;2076;8.490159459847725;26.81473456121343;16.609328746299703;BU
2020-04-18;León;8114;555;7952;1975;24089;16066;2530;6.840029578506285;24.83651911468813;15.747541391758993;LE
2020-04-18;Palencia;2502;146;1616;425;34120;4118;571;5.835331734612311;26.299504950495052;13.865954346770277;PA
2020-04-19;Ávila;3655;321;3416;1414;5019;7071;1735;8.78248974008208;41.39344262295082;24.536840616603026;AV
2020-04-19;Castilla y León;31161;2668;55496;15559;99999;86657;18227;8.561984531946985;28.03625486521551;21.033499890372386;CyL
2020-04-20;Segovia;1086;277;5434;1873;40004;6520;2150;25.50644567219153;34.46816341553184;32.97546012269939;SE
2020-04-20;Soria;2853;480;2272;949;42173;5125;1429;16.824395373291274;41.7693661971831;27.882926829268296;SO
2020-04-20;Valladolid;4355;92;19651;4531;47186;24006;4623;2.1125143513203213;23.057350770953132;19.25768557860535;VA
2020-04-21;Burgos;8886;624;6133;1528;9059;15019;2152;7.022282241728561;24.914397521604435;14.328517211532061;BU
2020-04-21;Castilla y León;39090;3392;60287;15937;99999;99377;19329;8.67741110258378;26.435218206246784;19.450174587681254;CyL
2020-04-22;León;11106;790;9387;2143;24089;20493;2933;7.113272105168377;22.829444977095985;14.312204167276633;LE
2020-04-22;Castilla y León;42954;3662;63313;16207;99999;106267;19869;8.525399264329282;25.598218375373143;18.69724373512003;CyL
2020-04-23;Salamanca;2155;469;9133;2714;37274;11288;3183;21.76334106728538;29.716413007774005;28.198086463501067;SA
2020-04-23;Valladolid;5634;145;23188;4763;47186;28822;4908;2.5736599219027334;20.54079696394687;17.028658663520922;VA
2020-04-23;Zamora;1302;120;2420;336;49275;3722;456;9.216589861751153;13.884297520661157;12.251477700161203;ZA
2020-04-24;Palencia;4553;202;2049;472;34120;6602;674;4.436635185591918;23.035627135187898;10.209027567403817;PA
2020-04-24;Castilla y León;47639;3994;69178;16571;99999;116817;20565;8.383887151283611;23.954147272254183;17.6044582552197;CyL
2020-04-25;Burgos;10063;652;7216;1631;9059;17279;2283;6.479181158700189;22.602549889135254;13.212570171884947;BU
2020-04-25;Salamanca;2438;519;9833;2768;37274;12271;3287;21.287940935192783;28.150106783280787;26.786732947600033;SA
2020-04-25;Valladolid;6351;160;24985;4810;47186;31336;4970;2.519288301054952;19.251550930558334;15.860352310441664;VA
2020-04-25;Castilla y León;48702;4068;71660;16703;99999;120362;20771;8.352839719108045;23.30867987719788;17.257107725029496;CyL
2020-04-26;Burgos;10079;652;7391;1670;9059;17470;2322;6.468895723782121;22.595048031389528;13.291356611333715;BU
2020-04-26;León;12318;855;11593;2301;24089;23911;3156;6.94106186069167;19.848184249115846;13.198946091756932;LE
2020-04-26;Palencia;4682;207;2459;542;34120;7141;749;4.4211875266979925;22.04148027653518;10.48872706903795;PA
2020-04-26;Zamora;1707;159;2694;342;49275;4401;501;9.314586994727591;12.694877505567929;11.38377641445126;ZA
2020-04-27;Palencia;4807;208;2660;559;34120;7467;767;4.327023091325151;21.01503759398496;10.271862863265033;PA
2020-04-27;Segovia;2189;519;6763;1899;40004;8952;2418;23.709456372772955;28.07925476859382;27.010723860589813;SE
2020-04-27;Zamora;2022;182;2750;343;49275;4772;525;9.000989119683481;12.472727272727273;11.001676445934619;ZA
2020-04-27;Castilla y León;52500;4318;77876;17104;99999;130376;21422;8.224761904761904;21.963120858801172;16.43093820948641;CyL
2020-04-28;León;13705;892;12327;2322;24089;26032;3214;6.508573513316309;18.836699926989535;12.346342962507682;LE
2020-04-28;Valladolid;7603;198;26800;4400;47186;34403;4598;2.6042351703275024;16.417910447761194;13.365113507542947;VA
2020-04-28;Zamora;2304;214;3450;541;49275;5754;755;9.288194444444445;15.681159420289855;13.121306916927356;ZA
2020-04-28;Castilla y León;56518;4515;80640;17241;99999;137158;21756;7.988605400049542;21.380208333333332;15.86199857099112;CyL
2020-04-29;León;14569;916;12953;2352;24089;27522;3268;6.287322396870067;18.15795568594148;11.87413705399317;LE
2020-04-29;Palencia;5164;215;3740;743;34120;8904;958;4.163439194422928;19.86631016042781;10.759209344115005;PA
2020-04-29;Salamanca;3965;623;10554;2730;37274;14519;3353;15.712484237074401;25.86696986924389;23.09387698877333;SA
2020-04-29;Segovia;3288;612;8659;2278;40004;11947;2890;18.613138686131386;26.307887746852987;24.190173265254874;SE
2020-04-30;Ávila;6012;441;5141;1573;5019;11153;2014;7.335329341317365;30.59716008558646;18.05792163543441;AV
2020-04-30;Burgos;12063;705;8653;1761;9059;20716;2466;5.844317333996518;20.351323240494626;11.903842440625603;BU
2020-04-30;Palencia;5282;218;4035;754;34120;9317;972;4.127224536160545;18.686493184634447;10.432542663947622;PA
2020-04-30;Castilla y León;66722;4999;86662;17502;99999;153384;22501;7.49228140643266;20.195702845537834;14.669717832368434;CyL
2020-05-01;León;15265;935;14104;2405;24089;29369;3340;6.125122830003275;17.05190017016449;11.372535666859614;LE
2020-05-01;Salamanca;5268;681;11066;2752;37274;16334;3433;12.927107061503417;24.868968010121094;21.017509489408596;SA
2020-05-01;Valladolid;8842;227;29675;4499;47186;38517;4726;2.5672924677674738;15.160909856781805;12.269906794402472;VA
2020-05-02;Ávila;6431;462;5429;1585;5019;11860;2047;7.183952728969056;29.195063547614662;17.259696458684655;AV
2020-05-02;Valladolid;9019;232;30014;4506;47186;39033;4738;2.572347266881029;15.012993936163124;12.138446955140521;VA
2020-05-02;Zamora;4358;349;3880;550;49275;8238;899;8.008260670032124;14.175257731958762;10.912842923039573;ZA
2020-05-03;León;15819;957;14642;2441;24089;30461;3398;6.049687085150768;16.671219778718754;11.155247693772365;LE
2020-05-03;Zamora;4366;349;3905;550;49275;8271;899;7.993586807146129;14.084507042253522;10.869302381815983;ZA
2020-05-03;Castilla y León;72990;5347;91794;17682;99999;164784;23029;7.32566104945883;19.26269690829466;13.975264588795028;CyL
2020-05-04;Ávila;7190;498;5695;1593;5019;12885;2091;6.9262865090403345;27.971905179982443;16.228172293364377;AV
2020-05-04;Burgos;13430;741;9367;1795;9059;22797;2536;5.517498138495905;19.163019109640224;11.124270737377726;BU
2020-05-04;Segovia;5296;802;9504;2294;40004;14800;3096;15.143504531722055;24.137205387205388;20.91891891891892;SE
2020-05-04;Valladolid;11770;273;31139;4546;47186;42909;4819;2.3194562446898894;14.599055846366294;11.230744132932486;VA
2020-05-05;Ávila;7607;523;5829;1594;5019;13436;2117;6.875246483502037;27.346028478298162;15.756177433760046;AV
2020-05-05;Soria;9421;1061;3185;981;42173;12606;2042;11.262074089799384;30.800627943485086;16.19863557036332;SO
2020-05-05;Zamora;6427;452;4120;555;49275;10547;1007;7.032830247393808;13.470873786407767;9.547738693467336;ZA
2020-05-06;León;17617;1054;15464;2454;24089;33081;3508;5.982857467219163;15.869115364718056;10.604274356881593;LE
2020-05-06;Valladolid;17045;423;32792;4595;47186;49837;5018;2.4816661777647404;14.012564040009758;10.068824367437848;VA
2020-05-06;Zamora;7900;649;4218;563;49275;12118;1212;8.215189873417723;13.347558084400191;10.001650437365903;ZA
2020-05-06;Castilla y León;99577;6770;98747;17865;99999;198324;24635;6.798758749510429;18.091688861433767;12.421592948911881;CyL
2020-05-07;Ávila;8866;598;6064;1602;5019;14930;2200;6.744868035190615;26.41820580474934;14.735432016075018;AV
2020-05-07;Soria;10664;1153;3346;987;42173;14010;2140;10.812078019504877;29.497907949790797;15.274803711634547;SO
2020-05-08;Palencia;8241;316;5229;784;34120;13470;1100;3.8344861060550905;14.99330655957162;8.166295471417966;PA
2020-05-08;Segovia;8145;1021;10394;2301;40004;18539;3322;12.535297728667894;22.137771791418125;17.918981606343383;SE
2020-05-08;Valladolid;22212;580;34762;4671;47186;56974;5251;2.611201152530164;13.437086473735688;9.21648471232492;VA
2020-05-09;Palencia;8344;319;5436;788;34120;13780;1107;3.8231064237775647;14.495952906548935;8.033381712626996;PA
2020-05-09;Salamanca;14778;1224;13150;2793;37274;27928;4017;8.28258221680877;21.23954372623574;14.383414494414207;SA
2020-05-09;Valladolid;22245;581;35315;4707;47186;57560;5288;2.6118228815464146;13.328613903440464;9.186935371785962;VA
2020-05-10;Ávila;10296;680;6476;1617;5019;16772;2297;6.6045066045066045;24.96911673872761;13.695444788933939;AV
2020-05-10;Palencia;8491;321;5528;793;34120;14019;1114;3.7804734424684963;14.345151953690305;7.946358513446038;PA
2020-05-10;Segovia;8476;1082;10682;2306;40004;19158;3388;12.765455403492213;21.58771765586969;17.684518216932872;SE
2020-05-10;Zamora;10797;805;4722;591;49275;15519;1396;7.455774752245994;12.515883100381195;8.995424962948643;ZA
2020-05-11;Burgos;19091;963;10878;1841;9059;29969;2804;5.044261693991933;16.924066924066924;9.356334879375353;BU
2020-05-11;Salamanca;15899;1292;13592;2794;37274;29491;4086;8.126297251399459;20.5562095350206;13.855074429486963;SA
2020-05-11;Segovia;9614;1149;10912;2309;40004;20526;3458;11.951320990222591;21.160190615835777;16.846925850141282;SE
2020-05-12;Segovia;10520;1205;11163;2313;40004;21683;3518;11.454372623574145;20.720236495565707;16.22469215514458;SE
2020-05-12;Valladolid;27235;723;36612;4710;47186;63847;5433;2.65467229667707;12.864634546050475;8.509405297038231;VA
2020-05-13;León;22549;1362;18087;2512;24089;40636;3874;6.040179165373187;13.888428152816939;9.53341864356728;LE
2020-05-13;Segovia;11170;1265;11442;2319;40004;22612;3584;11.324977618621308;20.2674357629785;15.849991155138865;SE
2020-05-13;Valladolid;27857;751;37209;4726;47186;65066;5477;2.69591126108339;12.701228197479105;8.417606737773953;VA
2020-05-13;Zamora;14067;988;5053;593;49275;19120;1581;7.023530248098386;11.735602612309519;8.268828451882845;ZA
2020-05-14;León;23638;1472;18897;2524;24089;42535;3996;6.2272611896099495;13.35661745250569;9.394616198424826;LE
2020-05-14;Palencia;12711;395;6206;811;34120;18917;1206;3.1075446463692864;13.067998710924911;6.375218057831581;PA
2020-05-14;Salamanca;19526;1527;14926;2812;37274;34452;4339;7.820342107958619;18.83960873643307;12.594334146058284;SA
2020-05-15;León;24806;1604;19473;2533;24089;44279;4137;6.466177537692494;13.007754326503363;9.343029427042165;LE
2020-05-15;Segovia;12477;1423;11912;2324;40004;24389;3747;11.4049851727178;19.509738079247818;15.363483537660422;SE
2020-05-15;Valladolid;30590;1152;38215;4760;47186;68805;5912;3.7659365805818896;12.455841946879499;8.592398808226147;VA
2020-05-16;Ávila;14213;898;7136;1623;5019;21349;2521;6.318159431506368;22.74383408071749;11.808515621340577;AV
2020-05-16;Valladolid;30627;1155;38522;4768;47186;69149;5923;3.7711822901361547;12.377342817091531;8.565561324097239;VA
2020-05-16;Zamora;16572;1140;5652;609;49275;22224;1749;6.879073135409124;10.774946921443737;7.86987041036717;ZA
2020-05-17;Ávila;14373;907;7256;1623;5019;21629;2530;6.310443192096292;22.367695700110254;11.697258310601507;AV
2020-05-17;Soria;14757;1426;4426;1015;42173;19183;2441;9.66321067967744;22.932670582919116;12.724808424125527;SO
2020-05-17;Valladolid;30700;1158;38626;4777;47186;69326;5935;3.771986970684039;12.367317351007094;8.561001644404696;VA
2020-05-18;Burgos;27810;1435;12884;1879;9059;40694;3314;5.160014383315354;14.583980130394286;8.143706688946773;BU
2020-05-18;León;26483;1656;20580;2553;24089;47063;4209;6.253068005890572;12.405247813411078;8.943331279348959;LE
2020-05-18;Palencia;13830;432;6628;826;34120;20458;1258;3.123644251626898;12.462281231140615;6.1491836934206665;PA
2020-05-18;Salamanca;22427;1748;15824;2821;37274;38251;4569;7.794176662059125;17.827350859453993;11.944785757235104;SA
2020-05-18;Soria;15046;1444;4447;1015;42173;19493;2459;9.597235145553636;22.824375983809308;12.614784794541631;SO
2020-05-19;Burgos;29119;1502;13198;1884;9059;42317;3386;5.158144167038703;14.27489013486892;8.001512394545927;BU
2020-05-19;Salamanca;23779;1826;15982;2823;37274;39761;4649;7.67904453509399;17.663621574271055;11.692361862126203;SA
2020-05-19;Valladolid;33734;1325;39833;4793;47186;73567;6118;3.927787988379676;12.032736675620717;8.316228743866136;VA
2020-05-20;Ávila;19545;1149;7717;1629;5019;27262;2778;5.87874136607828;21.109239341713103;10.190008069840804;AV
2020-05-20;Burgos;30005;1572;13673;1884;9059;43678;3456;5.239126812197966;13.778980472463981;7.912450203763909;BU
2020-05-20;León;28877;1786;21704;2561;24089;50581;4347;6.184852997194999;11.799668263914485;8.594136138075562;LE
2020-05-20;Palencia;15794;493;6993;836;34120;22787;1329;3.1214385209573257;11.954811954811955;5.8322727871154605;PA
2020-05-20;Salamanca;24973;1875;16063;2824;37274;41036;4699;7.508108757458054;17.58077569569819;11.450921142411541;SA
2020-05-20;Zamora;21174;1255;6084;612;49275;27258;1867;5.927080381600076;10.059171597633137;6.849365323941595;ZA
2020-05-20;Castilla y León;207884;12899;130363;18506;99999;338247;31405;6.20490273421716;14.195745725397543;9.284635192625508;CyL
2020-05-21;Ávila;20212;1184;7827;1629;5019;28039;2813;5.8579061943399955;20.812571866615563;10.032454795106815;AV
2020-05-21;Palencia;16524;529;7159;838;34120;23683;1367;3.2014040183974823;11.70554546724403;5.772072794831736;PA
2020-05-21;Soria;16269;1506;4785;1026;42173;21054;2532;9.25686889175733;21.442006269592476;12.026218295810773;SO
2020-05-21;Zamora;23248;1299;6249;612;49275;29497;1911;5.587577426015141;9.793566970715315;6.478624944909652;ZA
2020-05-22;Burgos;32447;1694;14477;1898;9059;46924;3592;5.220821647609949;13.11045106030255;7.654931378399113;BU
2020-05-22;León;30727;1927;22967;2572;24089;53694;4499;6.27135743808377;11.198676361736403;8.378962267664916;LE
2020-05-22;Salamanca;28010;2004;17324;2847;37274;45334;4851;7.154587647268833;16.433848995613022;10.70057793267746;SA
2020-05-22;Segovia;16961;1949;13508;2343;40004;30469;4292;11.491067743647191;17.34527687296417;14.086448521448029;SE
2020-05-23;Ávila;21405;1226;8082;1631;5019;29487;2857;5.727633730436814;20.18064835436773;9.689015498355207;AV
2020-05-23;Burgos;32469;1694;14861;1902;9059;47330;3596;5.21728417875512;12.798600363367202;7.597718149165435;BU
2020-05-24;Burgos;32475;1694;15081;1903;9059;47556;3597;5.216320246343341;12.618526622902989;7.563714357809741;BU
2020-05-24;León;31051;1938;23464;2574;24089;54515;4512;6.24134488422273;10.96999659052165;8.276621113455013;LE
2020-05-24;Salamanca;28246;2009;17895;2861;37274;46141;4870;7.112511506053955;15.987706063146131;10.554604364881559;SA
2020-05-24;Valladolid;38884;1613;42148;4830;47186;81032;6443;4.1482357782121175;11.459618487235455;7.951179780827328;VA
2020-05-24;Castilla y León;228761;13955;139751;18635;99999;368512;32590;6.1002531025830455;13.334430522858511;8.843674018756513;CyL
2020-05-25;Ávila;22078;1264;8302;1633;5019;30380;2897;5.725156264154362;19.66995904601301;9.535878867676102;AV
2020-05-25;Palencia;18069;557;7646;844;34120;25715;1401;3.08262770490896;11.03845147789694;5.448181994944585;PA
2020-05-25;Zamora;25407;1365;6663;612;49275;32070;1977;5.3725351281143;9.185051778478163;6.164639850327409;ZA
2020-05-25;Castilla y León;236431;14374;141465;18652;99999;377896;33026;6.079575013428865;13.184886721097092;8.739441539471176;CyL
2020-05-26;Palencia;18653;585;7846;852;34120;26499;1437;3.136224735967405;10.85903645169513;5.4228461451375525;PA
2020-05-26;Valladolid;42351;1795;43319;4846;47186;85670;6641;4.238388703926708;11.186777164754496;7.7518384498657635;VA
2020-05-27;Ávila;23727;1319;8591;1646;5019;32318;2965;5.55906772874784;19.15958561285066;9.17445386471935;AV
2020-05-27;Burgos;36290;1877;16103;1921;9059;52393;3798;5.1722237531000275;11.929454138980313;7.24905998892982;BU
2020-05-27;Salamanca;30491;2176;18702;2886;37274;49193;5062;7.136532091436817;15.431504651908886;10.290081922224708;SA
2020-05-27;Zamora;26444;1398;6969;613;49275;33413;2011;5.286643472999546;8.796097001004448;6.018615508933649;ZA
2020-05-27;Castilla y León;252156;15210;146680;18739;99999;398836;33949;6.031980202731643;12.775429506408509;8.512019978136378;CyL
2020-05-28;Segovia;20072;2313;14684;2355;40004;34756;4668;11.523515344758868;16.037864342141106;13.43077454252503;SE
2020-05-29;Burgos;38319;1953;16976;1934;9059;55295;3887;5.096688326939638;11.392554194156457;7.029568677095578;BU
2020-05-29;León;35978;2160;25881;2587;24089;61859;4747;6.003668908777586;9.995749777829294;7.673903554858629;LE
2020-05-29;Salamanca;32304;2296;19267;2906;37274;51571;5202;7.107478949975235;15.082784034878289;10.08706443543852;SA
2020-05-29;Segovia;20360;2349;14905;2353;40004;35265;4702;11.537328094302554;15.786648775578666;13.333333333333334;SE
2020-05-29;Castilla y León;265163;15815;152320;18821;99999;417483;34636;5.964255948228072;12.3562237394958;8.29638572109523;CyL
2020-05-30;Salamanca;32321;2297;19546;2911;37274;51867;5208;7.106834565762197;14.8930727514581;10.041066574122274;SA
2020-05-30;Zamora;27775;1438;7505;617;49275;35280;2055;5.177317731773178;8.221185876082611;5.824829931972789;ZA
2020-05-30;Castilla y León;265763;15828;154693;18869;99999;420456;34697;5.955682318456669;12.197707717867;8.252230911201172;CyL
2020-05-31;Palencia;20436;653;8733;865;34120;29169;1518;3.19534155412018;9.904958204511622;5.204155096163735;PA
2020-05-31;Salamanca;32329;2299;19697;2913;37274;52026;5212;7.111262334127254;14.789054170685892;10.018067889132357;SA
2020-05-31;Segovia;20455;2354;15066;2353;40004;35521;4707;11.508188706917624;15.617947696800744;13.2513161228569;SE
2020-05-31;Castilla y León;266072;15847;155711;18903;99999;421783;34750;5.955906671878289;12.139797445267194;8.238833713070465;CyL
2020-06-01;Salamanca;32861;2343;19799;2916;37274;52660;5259;7.130032561394967;14.728016566493258;9.986707178123813;SA
2020-06-01;Castilla y León;269305;16090;157128;18914;99999;426433;35004;5.974638421121034;12.037319892062524;8.208557968074704;CyL
2020-06-02;Burgos;39405;2012;18470;1953;9059;57875;3965;5.105951021443979;10.57390362750406;6.85097192224622;BU
2020-06-02;Palencia;20749;677;9008;868;34120;29757;1545;3.2628078461612606;9.63587921847247;5.1920556507712465;PA
2020-06-02;Segovia;20802;2396;15479;2354;40004;36281;4750;11.518123257379099;15.207700755862783;13.092252142994957;SE
2020-06-02;Soria;19936;1710;6012;1072;42173;25948;2782;8.57744783306581;17.83100465735196;10.721442885771543;SO
2020-06-02;Zamora;28124;1445;7675;617;49275;35799;2062;5.137960460816385;8.039087947882736;5.759937428419788;ZA
2020-06-03;Segovia;21002;2435;15708;2356;40004;36710;4791;11.594133892010285;14.998726763432646;13.05093979842005;SE
2020-06-03;Valladolid;48308;2111;47587;4899;47186;95895;7010;4.36987662498965;10.294828419526342;7.310078731946399;VA
2020-06-04;Ávila;26547;1445;9785;1672;5019;36332;3117;5.4431762534373;17.0873786407767;8.579213916107014;AV
2020-06-04;León;39357;2323;28815;2606;24089;68172;4929;5.902380770892091;9.043900746139164;7.23024115472628;LE
2020-06-04;Segovia;21114;2446;15881;2356;40004;36995;4802;11.584730510561712;14.835337825073989;12.980132450331125;SE
2020-06-04;Valladolid;48995;2147;48223;4901;47186;97218;7048;4.382079804061639;10.163200132716753;7.249686272089531;VA
2020-06-05;León;40240;2382;29417;2607;24089;69657;4989;5.91948310139165;8.862222524390658;7.162237822472975;LE
2020-06-05;Salamanca;35266;2554;21104;2945;37274;56370;5499;7.242102875290649;13.95470053070508;9.755188930282065;SA
2020-06-05;Segovia;21523;2462;16082;2356;40004;37605;4818;11.438925800306649;14.649919164283048;12.81212604706821;SE
2020-06-05;Castilla y León;287538;17128;170020;19055;99999;457558;36183;5.956777886748882;11.207504999411833;7.907849933778888;CyL
2020-06-06;Salamanca;35435;2554;21546;2955;37274;56981;5509;7.2075631437843946;13.714842662211083;9.668134992365877;SA
2020-06-06;Soria;20768;1759;6454;1087;42173;27222;2846;8.469761171032356;16.842268360706537;10.454779222687533;SO
2020-06-06;Castilla y León;288204;17158;172963;19090;99999;461167;36248;5.953421881722669;11.037042604487665;7.860059371117188;CyL
2020-06-07;Salamanca;35444;2554;21720;2957;37274;57164;5511;7.2057329872474885;13.614180478821364;9.640682947309495;SA
2020-06-07;Segovia;21651;2475;16277;2364;40004;37928;4839;11.431342663156437;14.523560852736992;12.758384307108205;SE
2020-06-07;Soria;20900;1767;6473;1088;42173;27373;2855;8.454545454545455;16.808280549976825;10.429985752383736;SO
2020-06-07;Zamora;29337;1469;8260;621;49275;37597;2090;5.007328629375873;7.518159806295399;5.558954171875415;ZA
2020-06-08;Ávila;27482;1474;10354;1682;5019;37836;3156;5.3635106615239065;16.244929495847018;8.341262289882652;AV
2020-06-09;Ávila;27713;1487;10488;1683;5019;38201;3170;5.365712842348357;16.04691075514874;8.298212088688778;AV
2020-06-09;Salamanca;36060;2636;22273;2969;37274;58333;5605;7.31003882418192;13.330040856642572;9.60862633500763;SA
2020-06-09;Segovia;22225;2508;16635;2367;40004;38860;4875;11.28458942632171;14.229035166816953;12.545033453422544;SE
2020-06-09;Soria;21522;1790;6689;1092;42173;28211;2882;8.31707090419106;16.32531021079384;10.215873240934387;SO
2020-06-10;León;42470;2500;32137;2619;24089;74607;5119;5.88650812338121;8.149485017269814;6.861286474459501;LE
2020-06-10;Salamanca;36467;2670;22657;2976;37274;59124;5646;7.321688101571283;13.135013461623341;9.549421554698599;SA
2020-06-11;Salamanca;37147;2696;23077;2984;37274;60224;5680;7.257652031119606;12.930623564588117;9.431455897980872;SA
2020-06-11;Soria;22228;1820;6895;1106;42173;29123;2926;8.18787115350009;16.040609137055835;10.047041856951552;SO
2020-06-11;Zamora;30364;1495;8698;625;49275;39062;2120;4.923593729416415;7.185559898827316;5.427269469049204;ZA
2020-06-14;Burgos;43507;2197;23989;1991;9059;67496;4188;5.04976210724711;8.299637333777982;6.2048121370155265;BU
2020-06-14;Salamanca;37553;2710;23460;2985;37274;61013;5695;7.216467392751577;12.72378516624041;9.334076344385622;SA
2020-06-14;Valladolid;54863;2398;52720;4939;47186;107583;7337;4.370887483367661;9.36836115326252;6.819850719909279;VA
2020-06-14;Castilla y León;309752;18083;189990;19245;99999;499742;37328;5.837896123350293;10.12948049897363;7.469454238387008;CyL
2020-06-16;Ávila;29721;1551;11512;1691;5019;41233;3242;5.218532350863026;14.689020152883947;7.862634297771202;AV
2020-06-16;Zamora;31133;1518;9180;628;49275;40313;2146;4.875855201875822;6.840958605664488;5.323344826730831;ZA
2020-06-17;León;46685;2632;35136;2628;24089;81821;5260;5.637785155831638;7.479508196721311;6.428667457009814;LE
2020-06-17;Valladolid;57713;2486;54650;4975;47186;112363;7461;4.307521702216138;9.10338517840805;6.640086149355215;VA
2020-06-17;Castilla y León;322299;18498;197025;19312;99999;519324;37810;5.7393910623365265;9.801801801801801;7.280618650399365;CyL
2020-06-18;Ávila;30727;1569;11883;1694;5019;42610;3263;5.1062583395710615;14.255659345283178;7.65782680122037;AV
2020-06-18;Burgos;45686;2253;25112;1993;9059;70798;4246;4.93148885873134;7.936444727620261;5.997344557755869;BU
2020-06-18;Palencia;24799;817;11861;911;34120;36660;1728;3.2944876809548775;7.6806340106230495;4.713584288052373;PA
2020-06-18;Zamora;31917;1528;9455;628;49275;41372;2156;4.787417363787323;6.641988365943945;5.211253988204582;ZA
2020-06-19;Ávila;31094;1576;12002;1694;5019;43096;3270;5.068501961793272;14.114314280953174;7.58771115648784;AV
2020-06-19;Burgos;45723;2254;25316;1994;9059;71039;4248;4.929685278743739;7.876441775951967;5.979813905038077;BU
2020-06-19;Palencia;24927;821;12116;912;34120;37043;1733;3.2936173626990812;7.527236711786069;4.678346786167427;PA
2020-06-19;Salamanca;40310;2885;24928;2995;37274;65238;5880;7.1570329942942195;12.014602053915276;9.01315184401729;SA
2020-06-19;Soria;24279;1887;7579;1121;42173;31858;3008;7.772148770542445;14.79086950785064;9.441898424257642;SO
2020-06-20;Ávila;31281;1576;12186;1699;5019;43467;3275;5.038202103513314;13.942228787132777;7.5344514229185355;AV
2020-06-20;Palencia;24933;821;12272;914;34120;37205;1735;3.2928247703846307;7.447848761408084;4.663351700040317;PA
2020-06-20;Salamanca;40395;2885;25134;2999;37274;65529;5884;7.141973016462433;11.932044242858279;8.979230569671442;SA
2020-06-20;Segovia;24347;2599;18275;2382;40004;42622;4981;10.67482646732657;13.034199726402187;11.686453005490122;SE
2020-06-20;Soria;24324;1891;7686;1125;42173;32010;3016;7.774214767308009;14.637002341920374;9.422055607622617;SO
2020-06-20;Valladolid;59328;2563;56453;4990;47186;115781;7553;4.320051240560949;8.839211379377536;6.52352285780914;VA
2020-06-20;Zamora;32453;1536;9642;629;49275;42095;2165;4.73299849012418;6.523542833437046;5.143128637605416;ZA
2020-06-20;Castilla y León;330707;18788;203565;19365;99999;534272;38153;5.681161874408464;9.512931987325915;7.141119130330618;CyL
2020-06-21;Burgos;45730;2254;25730;1997;9059;71460;4251;4.9289306800787225;7.761368052856588;5.948782535684298;BU
2020-06-21;León;47921;2663;36424;2630;24089;84345;5293;5.557062665637194;7.220513946848232;6.275416444365405;LE
2020-06-21;Salamanca;40397;2885;25308;2999;37274;65705;5884;7.141619427185188;11.850007902639481;8.955178449128681;SA
2020-06-22;Burgos;45870;2260;25935;1998;9059;71805;4258;4.926967516895575;7.703875072296125;5.929949167885245;BU
2020-06-22;Palencia;25010;830;12578;916;34120;37588;1746;3.318672530987605;7.282556845285419;4.6450994998403745;PA
2020-06-22;Salamanca;40742;2920;25512;3002;37274;66254;5922;7.167051200235629;11.767011602383192;8.938328251879133;SA
2020-03-13;Soria;0;0;2;1;42173;2;1;;50.0;50.0;SO
2020-03-14;León;0;0;148;43;24089;148;43;;29.054054054054053;29.054054054054053;LE
2020-03-15;León;0;0;191;63;24089;191;63;;32.98429319371728;32.98429319371728;LE
2020-03-15;Palencia;0;0;4;0;34120;4;0;;0.0;0.0;PA
2020-03-16;Ávila;0;0;65;26;5019;65;26;;40.0;40.0;AV
2020-03-16;Burgos;0;0;381;116;9059;381;116;;30.446194225721783;30.446194225721783;BU
2020-03-16;Salamanca;0;0;238;73;37274;238;73;;30.672268907563026;30.672268907563026;SA
2020-03-16;Soria;0;0;30;22;42173;30;22;;73.33333333333333;73.33333333333333;SO
2020-03-16;Zamora;0;0;52;5;49275;52;5;;9.615384615384617;9.615384615384617;ZA
2020-03-17;León;0;0;328;115;24089;328;115;;35.0609756097561;35.0609756097561;LE
2020-03-17;Salamanca;0;0;349;130;37274;349;130;;37.249283667621775;37.249283667621775;SA
2020-03-17;Soria;0;0;70;46;42173;70;46;;65.71428571428571;65.71428571428571;SO
2020-03-17;Zamora;0;0;87;13;49275;87;13;;14.942528735632186;14.942528735632186;ZA
2020-03-18;Ávila;0;0;138;58;5019;138;58;;42.028985507246375;42.028985507246375;AV
2020-03-18;León;0;0;438;149;24089;438;149;;34.01826484018265;34.01826484018265;LE
2020-03-18;Palencia;0;0;8;0;34120;8;0;;0.0;0.0;PA
2020-03-18;Segovia;0;0;204;121;40004;204;121;;59.31372549019608;59.31372549019608;SE
2020-03-19;Burgos;0;0;601;199;9059;601;199;;33.11148086522462;33.11148086522462;BU
2020-03-19;Palencia;0;0;12;1;34120;12;1;;8.333333333333332;8.333333333333332;PA
2020-03-20;Ávila;0;0;248;133;5019;248;133;;53.62903225806451;53.62903225806451;AV
2020-03-20;León;0;0;662;233;24089;662;233;;35.196374622356494;35.196374622356494;LE
2020-03-20;Salamanca;0;0;652;276;37274;652;276;;42.331288343558285;42.331288343558285;SA
2020-03-20;Soria;0;0;159;113;42173;159;113;;71.0691823899371;71.0691823899371;SO
2020-03-20;Zamora;0;0;181;46;49275;181;46;;25.41436464088398;25.41436464088398;ZA
2020-03-20;Castilla y León;0;0;4184;1533;99999;4184;1533;;36.6395793499044;36.6395793499044;CyL
2020-03-21;León;0;0;771;284;24089;771;284;;36.835278858625166;36.835278858625166;LE
2020-03-21;Palencia;0;0;19;2;34120;19;2;;10.526315789473683;10.526315789473683;PA
2020-03-21;Salamanca;0;0;778;344;37274;778;344;;44.2159383033419;44.2159383033419;SA
2020-03-21;Soria;0;0;182;129;42173;182;129;;70.87912087912088;70.87912087912088;SO
2020-03-21;Valladolid;0;0;1499;412;47186;1499;412;;27.484989993328885;27.484989993328885;VA
2020-03-21;Castilla y León;0;0;4853;1849;99999;4853;1849;;38.100144240675874;38.100144240675874;CyL
2020-03-22;Salamanca;0;0;957;452;37274;957;452;;47.23092998955068;47.23092998955068;SA
2020-03-23;Ávila;0;0;385;214;5019;385;214;;55.58441558441558;55.58441558441558;AV
2020-03-23;Palencia;0;0;24;3;34120;24;3;;12.5;12.5;PA
2020-03-23;Valladolid;0;0;1916;593;47186;1916;593;;30.949895615866392;30.949895615866392;VA
2020-03-23;Zamora;0;0;308;89;49275;308;89;;28.8961038961039;28.8961038961039;ZA
2020-03-24;León;0;0;1215;501;24089;1215;501;;41.23456790123457;41.23456790123457;LE
2020-03-24;Segovia;0;0;677;376;40004;677;376;;55.53914327917282;55.53914327917282;SE
2020-03-24;Soria;0;0;315;223;42173;315;223;;70.7936507936508;70.7936507936508;SO
2020-03-24;Valladolid;0;0;2268;781;47186;2268;781;;34.43562610229277;34.43562610229277;VA
2020-03-25;Burgos;0;0;1255;505;9059;1255;505;;40.23904382470119;40.23904382470119;BU
2020-03-25;Segovia;0;0;895;504;40004;895;504;;56.31284916201117;56.31284916201117;SE
2020-03-25;Soria;0;0;399;282;42173;399;282;;70.67669172932331;70.67669172932331;SO
2020-03-25;Valladolid;0;0;2587;951;47186;2587;951;;36.76072671047545;36.76072671047545;VA
2020-03-25;Zamora;0;0;340;98;49275;340;98;;28.823529411764703;28.823529411764703;ZA
2020-03-25;Castilla y León;0;0;9122;4001;99999;9122;4001;;43.86099539574655;43.86099539574655;CyL
2020-03-26;Burgos;0;0;1463;594;9059;1463;594;;40.6015037593985;40.6015037593985;BU
2020-03-26;Salamanca;0;0;1895;869;37274;1895;869;;45.857519788918204;45.857519788918204;SA
2020-03-26;Segovia;0;0;1155;688;40004;1155;688;;59.56709956709957;59.56709956709957;SE
2020-03-26;Soria;0;0;546;376;42173;546;376;;68.86446886446886;68.86446886446886;SO
2020-03-26;Valladolid;0;0;2934;1104;47186;2934;1104;;37.627811860940696;37.627811860940696;VA
2020-03-26;Zamora;0;0;418;119;49275;418;119;;28.4688995215311;28.4688995215311;ZA
2020-03-26;Castilla y León;0;0;10892;4886;99999;10892;4886;;44.8586118251928;44.8586118251928;CyL
2020-03-27;Ávila;0;0;845;466;5019;845;466;;55.14792899408284;55.14792899408284;AV
2020-03-27;Burgos;0;0;1629;669;9059;1629;669;;41.06813996316759;41.06813996316759;BU
2020-03-27;Palencia;0;0;57;13;34120;57;13;;22.807017543859647;22.807017543859647;PA
2020-03-27;Salamanca;0;0;2257;1059;37274;2257;1059;;46.92069118298626;46.92069118298626;SA
2020-03-27;Soria;0;0;618;418;42173;618;418;;67.63754045307444;67.63754045307444;SO
2020-03-28;Ávila;0;0;877;478;5019;877;478;;54.50399087799316;54.50399087799316;AV
2020-03-28;Segovia;0;0;1610;967;40004;1610;967;;60.06211180124224;60.06211180124224;SE
2020-03-28;Valladolid;0;0;3552;1309;47186;3552;1309;;36.85247747747748;36.85247747747748;VA
2020-03-29;Burgos;0;0;1839;750;9059;1839;750;;40.78303425774878;40.78303425774878;BU
2020-03-29;León;0;0;2288;1004;24089;2288;1004;;43.88111888111888;43.88111888111888;LE
2020-03-29;Segovia;0;0;1719;1035;40004;1719;1035;;60.20942408376963;60.20942408376963;SE
2020-03-30;Ávila;0;0;1107;597;5019;1107;597;;53.929539295392956;53.929539295392956;AV
2020-03-30;León;0;0;2408;1042;24089;2408;1042;;43.27242524916943;43.27242524916943;LE
2020-03-30;Palencia;0;0;267;100;34120;267;100;;37.453183520599254;37.453183520599254;PA
2020-03-30;Segovia;0;0;1807;1078;40004;1807;1078;;59.65688987271721;59.65688987271721;SE
2020-03-31;Ávila;0;0;1296;710;5019;1296;710;;54.78395061728395;54.78395061728395;AV
2020-03-31;León;0;0;2596;1108;24089;2596;1108;;42.68104776579353;42.68104776579353;LE
2020-03-31;Palencia;0;0;333;125;34120;333;125;;37.53753753753754;37.53753753753754;PA
2020-03-31;Segovia;0;0;1982;1164;40004;1982;1164;;58.72855701311806;58.72855701311806;SE
2020-03-31;Soria;0;0;906;594;42173;906;594;;65.56291390728477;65.56291390728477;SO
2020-03-31;Valladolid;0;0;4274;1537;47186;4274;1537;;35.96162845109967;35.96162845109967;VA
2020-04-01;Zamora;0;0;821;218;49275;821;218;;26.552984165651644;26.552984165651644;ZA
2020-04-01;Castilla y León;26;2;19709;8378;99999;19735;8380;7.6923076923076925;42.508498655436604;42.46262984545224;CyL
2020-04-02;Ávila;34;3;1564;871;5019;1598;874;8.823529411764707;55.69053708439897;54.69336670838548;AV
2020-04-02;León;0;0;3057;1229;24089;3057;1229;;40.20281321557082;40.20281321557082;LE
2020-04-02;Palencia;0;0;520;190;34120;520;190;;36.53846153846153;36.53846153846153;PA
2020-04-02;Castilla y León;38;4;21438;8987;99999;21476;8991;10.526315789473683;41.92088814255061;41.86533805177873;CyL
2020-04-03;Burgos;0;0;2688;945;9059;2688;945;;35.15625;35.15625;BU
2020-04-03;León;0;0;3323;1284;24089;3323;1284;;38.63978332831778;38.63978332831778;LE
2020-04-03;Salamanca;6;1;4410;1762;37274;4416;1763;16.666666666666664;39.954648526077094;39.92300724637681;SA
2020-04-03;Segovia;0;0;2606;1400;40004;2606;1400;;53.72217958557176;53.72217958557176;SE
2020-04-03;Valladolid;0;0;5951;2093;47186;5951;2093;;35.1705595698202;35.1705595698202;VA
2020-04-04;Burgos;0;0;2854;972;9059;2854;972;;34.05746320953048;34.05746320953048;BU
2020-04-04;Segovia;1;0;2944;1561;40004;2945;1561;0.0;53.02309782608695;53.00509337860782;SE
2020-04-04;Soria;0;0;1315;783;42173;1315;783;;59.543726235741445;59.543726235741445;SO
2020-04-04;Castilla y León;122;13;25390;10231;99999;25512;10244;10.655737704918032;40.29539188656951;40.15365318281593;CyL
2020-04-05;Palencia;0;0;748;257;34120;748;257;;34.35828877005348;34.35828877005348;PA
2020-04-06;Ávila;104;14;2072;1092;5019;2176;1106;13.461538461538462;52.702702702702695;50.82720588235294;AV
2020-04-06;Valladolid;4;0;7455;2559;47186;7459;2559;0.0;34.325955734406435;34.30754792867677;VA
2020-04-06;Castilla y León;241;32;28441;11159;99999;28682;11191;13.278008298755188;39.235610562216515;39.01750226622969;CyL
2020-04-07;Palencia;0;0;910;296;34120;910;296;;32.527472527472526;32.527472527472526;PA
2020-04-07;Segovia;7;3;3384;1713;40004;3391;1716;42.857142857142854;50.62056737588653;50.60454143320554;SE
2020-04-08;Ávila;245;24;2399;1190;5019;2644;1214;9.795918367346939;49.6040016673614;45.915279878971255;AV
2020-04-08;Valladolid;419;22;8958;2947;47186;9377;2969;5.250596658711217;32.89796829649475;31.662578649888022;VA
2020-04-09;Ávila;428;32;2453;1200;5019;2881;1232;7.476635514018691;48.91969017529556;42.76292953835474;AV
2020-04-09;Burgos;307;59;3651;1130;9059;3958;1189;19.218241042345277;30.950424541221583;30.040424456796362;BU
2020-04-09;Palencia;105;30;1111;359;34120;1216;389;28.57142857142857;32.313231323132314;31.990131578947366;PA
2020-04-09;Segovia;98;18;3603;1737;40004;3701;1755;18.367346938775512;48.2098251457119;47.41961631991354;SE
2020-04-09;Valladolid;483;26;10053;3148;47186;10536;3174;5.383022774327122;31.314035611260323;30.125284738041003;VA
2020-04-09;Zamora;155;19;1366;277;49275;1521;296;12.258064516129032;20.27818448023426;19.46088099934254;ZA
2020-04-10;Segovia;138;28;3815;1766;40004;3953;1794;20.28985507246377;46.29095674967235;45.38325322539843;SE
2020-04-10;Valladolid;607;28;11059;3491;47186;11666;3519;4.612850082372323;31.56704946197667;30.16458083319047;VA
2020-04-10;Castilla y León;5579;681;37290;13152;99999;42869;13833;12.206488618031905;35.269509251810135;32.26807249994168;CyL
2020-04-11;Burgos;819;175;4027;1200;9059;4846;1375;21.367521367521366;29.798857710454435;28.37391663227404;BU
2020-04-11;León;2286;207;5463;1669;24089;7749;1876;9.05511811023622;30.55097931539447;24.209575429087625;LE
2020-04-11;Palencia;258;48;1289;393;34120;1547;441;18.6046511627907;30.48875096974399;28.50678733031674;PA
2020-04-11;Segovia;155;28;3873;1770;40004;4028;1798;18.064516129032256;45.70100697134005;44.63753723932473;SE
2020-04-11;Valladolid;668;28;11891;3654;47186;12559;3682;4.191616766467066;30.72912286603313;29.317620829683893;VA
2020-04-12;Ávila;1211;150;2727;1276;5019;3938;1426;12.386457473162675;46.79134580124679;36.211274758760794;AV
2020-04-12;Segovia;201;39;4009;1784;40004;4210;1823;19.402985074626866;44.4998752806186;43.30166270783848;SE
2020-04-12;Soria;659;111;1858;913;42173;2517;1024;16.84370257966616;49.13885898815931;40.683353198251886;SO
2020-04-12;Valladolid;669;28;12815;3945;47186;13484;3973;4.185351270553064;30.784237222005462;29.464550578463367;VA
2020-04-13;Burgos;1537;199;4303;1243;9059;5840;1442;12.947299934938192;28.886823146641877;24.69178082191781;BU
2020-04-14;Ávila;2071;221;2857;1303;5019;4928;1524;10.67117334620956;45.6072803640182;30.925324675324678;AV
2020-04-14;Salamanca;529;60;7079;2481;37274;7608;2541;11.342155009451796;35.04732306822997;33.39905362776025;SA
2020-04-14;Segovia;330;74;4495;1816;40004;4825;1890;22.424242424242426;40.40044493882091;39.17098445595855;SE
2020-04-14;Soria;979;179;1917;922;42173;2896;1101;18.283963227783453;48.09598330725091;38.017955801104975;SO
2020-04-14;Castilla y León;13714;1383;45537;14569;99999;59251;15952;10.084585095522822;31.993763313349582;26.92275235860998;CyL
2020-04-15;Salamanca;742;113;7287;2526;37274;8029;2639;15.22911051212938;34.664470975710174;32.86835222319093;SA
2020-04-15;Valladolid;2235;64;16105;4291;47186;18340;4355;2.8635346756152127;26.64389941012108;23.745910577971646;VA
2020-04-15;Castilla y León;18046;1775;48084;14892;99999;66130;16667;9.83597473124238;30.970801098078365;25.203387267503402;CyL
2020-04-16;Salamanca;741;155;7465;2548;37274;8206;2703;20.917678812415655;34.13261888814467;32.93931269802584;SA
2020-04-16;Soria;1658;276;2040;935;42173;3698;1211;16.646562123039807;45.83333333333333;32.74743104380746;SO
2020-04-16;Castilla y León;22898;2070;50111;15111;99999;73009;17181;9.04009083762774;30.155055776176887;23.532715144708185;CyL
2020-04-17;Burgos;6329;588;5338;1457;9059;11667;2045;9.290567230210144;27.294866991382538;17.52807062655353;BU
2020-04-17;Soria;1983;283;2096;940;42173;4079;1223;14.27130610186586;44.847328244274806;29.982838931110567;SO
2020-04-17;Valladolid;3717;77;17529;4400;47186;21246;4477;2.0715630885122414;25.101260767870386;21.072201826226113;VA
2020-04-17;Zamora;633;58;1918;311;49275;2551;369;9.162717219589258;16.2148070907195;14.464915719325756;ZA
2020-04-18;Salamanca;1103;249;7964;2610;37274;9067;2859;22.57479601087942;32.772476142641885;31.531928973199513;SA
2020-04-18;Segovia;756;192;5169;1852;40004;5925;2044;25.396825396825395;35.82898046043722;34.49789029535865;SE
2020-04-18;Valladolid;3796;79;17757;4418;47186;21553;4497;2.0811380400421498;24.880328884383623;20.864844801187772;VA
2020-04-18;Zamora;660;62;1925;312;49275;2585;374;9.393939393939393;16.207792207792206;14.468085106382977;ZA
2020-04-19;Burgos;7491;604;5684;1494;9059;13175;2098;8.063008944066214;26.28430682617875;15.924098671726755;BU
2020-04-19;León;8291;556;8253;1991;24089;16544;2547;6.706066819442769;24.124560765782142;15.395309477756285;LE
2020-04-19;Salamanca;1211;276;8132;2627;37274;9343;2903;22.791081750619323;32.3044761436301;31.071390345713368;SA
2020-04-19;Segovia;949;235;5280;1864;40004;6229;2099;24.76290832455216;35.303030303030305;33.69722266816503;SE
2020-04-19;Valladolid;3828;80;18912;4478;47186;22740;4558;2.089864158829676;23.678087986463623;20.043975373790676;VA
2020-04-19;Zamora;661;62;1931;313;49275;2592;375;9.379727685325264;16.209218021750388;14.467592592592593;ZA
2020-04-20;Burgos;8098;614;5876;1512;9059;13974;2126;7.582119041738701;25.731790333560244;15.213968799198513;BU
2020-04-20;León;9239;664;8457;2003;24089;17696;2667;7.186924991882239;23.684521698001657;15.07120253164557;LE
2020-04-20;Palencia;3153;150;1705;436;34120;4858;586;4.757373929590866;25.57184750733138;12.06257719226019;PA
2020-04-20;Zamora;770;79;2159;324;49275;2929;403;10.25974025974026;15.006947660954145;13.758962103106862;ZA
2020-04-21;Ávila;4042;359;3742;1462;5019;7784;1821;8.881741712023752;39.070016034206304;23.39414182939363;AV
2020-04-21;León;10375;730;8939;2052;24089;19314;2782;7.036144578313253;22.95558787336391;14.404059231645439;LE
2020-04-21;Palencia;3637;165;1759;442;34120;5396;607;4.536706076436624;25.127913587265493;11.249073387694589;PA
2020-04-21;Salamanca;1825;415;8581;2675;37274;10406;3090;22.73972602739726;31.173522899428974;29.694407072842594;SA
2020-04-21;Segovia;1350;355;5578;1877;40004;6928;2232;26.296296296296294;33.65005378271782;32.21709006928407;SE
2020-04-21;Valladolid;4908;110;21013;4621;47186;25921;4731;2.2412387938060307;21.991148336743922;18.25161066316886;VA
2020-04-22;Burgos;9557;636;6368;1568;9059;15925;2204;6.65480799414042;24.623115577889447;13.839874411302983;BU
2020-04-22;Segovia;1523;404;5867;1890;40004;7390;2294;26.526592252133945;32.21407874552582;31.041948579161026;SE
2020-04-22;Soria;3767;573;2361;955;42173;6128;1528;15.211043270507036;40.44896230410843;24.934725848563968;SO
2020-04-23;Ávila;4151;369;3989;1484;5019;8140;1853;8.889424235124066;37.202306342441716;22.764127764127764;AV
2020-04-23;Burgos;9818;642;6690;1600;9059;16508;2242;6.539009981666327;23.916292974588938;13.581293918100314;BU
2020-04-23;León;11282;811;9891;2222;24089;21173;3033;7.188441765644389;22.464867050854313;14.324847683370331;LE
2020-04-23;Segovia;1632;415;5965;1891;40004;7597;2306;25.428921568627448;31.701592623637886;30.35408713966039;SE
2020-04-23;Castilla y León;44514;3794;65689;16427;99999;110203;20221;8.52316125263962;25.007231043249252;18.348865275899932;CyL
2020-04-24;Ávila;4381;379;4163;1499;5019;8544;1878;8.650992923989957;36.007686764352634;21.980337078651687;AV
2020-04-24;Burgos;10024;652;6928;1613;9059;16952;2265;6.504389465283319;23.282332563510394;13.361255309108069;BU
2020-04-24;León;12085;845;10564;2272;24089;22649;3117;6.992139015308234;21.507004922377888;13.762197006490354;LE
2020-04-24;Salamanca;2384;515;9355;2720;37274;11739;3235;21.60234899328859;29.0753607696419;27.55771360422523;SA
2020-04-24;Segovia;1738;433;6333;1891;40004;8071;2324;24.913693901035675;29.859466287699355;28.794449262792714;SE
2020-04-24;Soria;4522;655;2512;962;42173;7034;1617;14.484741264927022;38.296178343949045;22.98834233721922;SO
2020-04-25;Ávila;4406;383;4377;1525;5019;8783;1908;8.692691783931004;34.84121544436829;21.723784583855174;AV
2020-04-25;Palencia;4630;206;2059;472;34120;6689;678;4.449244060475162;22.92374939290918;10.136044251756616;PA
2020-04-25;Segovia;1903;461;6546;1895;40004;8449;2356;24.224908039936942;28.948976474182707;27.884956799621257;SE
2020-04-25;Zamora;1696;159;2652;341;49275;4348;500;9.375;12.858220211161386;11.499540018399264;ZA
2020-04-26;Ávila;4412;384;4518;1541;5019;8930;1925;8.703535811423391;34.108012394864986;21.556550951847704;AV
2020-04-26;Salamanca;2467;525;9941;2771;37274;12408;3296;21.280907985407378;27.87445930992858;26.563507414571248;SA
2020-04-26;Segovia;2017;476;6636;1896;40004;8653;2372;23.599405057015368;28.57142857142857;27.41245810701491;SE
2020-04-26;Castilla y León;49506;4149;73892;16876;99999;123398;21025;8.380802326990668;22.83873761706274;17.038363668779073;CyL
2020-04-27;Burgos;10564;660;7650;1687;9059;18214;2347;6.247633472169633;22.052287581699346;12.885692324585484;BU
2020-04-27;Salamanca;2616;556;10104;2775;37274;12720;3331;21.253822629969417;27.46437054631829;26.187106918238996;SA
2020-04-27;Soria;5748;750;2742;977;42173;8490;1727;13.048016701461378;35.630926331145155;20.34157832744405;SO
2020-04-28;Ávila;5176;413;4869;1560;5019;10045;1973;7.979134466769707;32.039433148490446;19.641612742658037;AV
2020-04-28;Burgos;11157;670;8010;1719;9059;19167;2389;6.005198530070808;21.460674157303373;12.464131058590286;BU
2020-04-28;Palencia;4997;211;3637;733;34120;8634;944;4.2225335201120675;20.153973054715422;10.93351864720871;PA
2020-04-28;Segovia;2588;566;8497;2271;40004;11085;2837;21.87017001545595;26.727080145933858;25.59314388813712;SE
2020-04-28;Soria;6099;768;2784;976;42173;8883;1744;12.592228234136742;35.05747126436782;19.63300686704942;SO
2020-04-29;Ávila;5566;429;4992;1564;5019;10558;1993;7.707509881422925;31.330128205128204;18.876681189619244;AV
2020-04-29;Soria;6340;797;2848;977;42173;9188;1774;12.570977917981072;34.30477528089887;19.30779277318241;SO
2020-04-29;Valladolid;8184;209;27837;4439;47186;36021;4648;2.553763440860215;15.946402270359595;12.903584020432527;VA
2020-04-29;Zamora;2764;281;3539;543;49275;6303;824;10.166425470332852;15.343317321277198;13.073139774710455;ZA
2020-04-30;Salamanca;4818;655;10883;2747;37274;15701;3402;13.594852635948525;25.24120187448314;21.66740971912617;SA
2020-04-30;Segovia;3964;680;8847;2285;40004;12811;2965;17.15438950554995;25.827964281677406;23.14417297634845;SE
2020-04-30;Valladolid;8800;224;28946;4474;47186;37746;4698;2.5454545454545454;15.456367028259518;12.446351931330472;VA
2020-05-01;Palencia;5395;219;4182;766;34120;9577;985;4.059314179796107;18.31659493065519;10.285057951341756;PA
2020-05-02;Palencia;5628;228;4427;769;34120;10055;997;4.051172707889126;17.370679918680825;9.91546494281452;PA
2020-05-02;Salamanca;5822;720;11336;2756;37274;17158;3476;12.366884232222604;24.31192660550459;20.258771418580253;SA
2020-05-04;Soria;8418;975;3134;981;42173;11552;1956;11.58232359230221;31.3018506700702;16.93213296398892;SO
2020-05-05;Salamanca;8037;850;11973;2772;37274;20010;3622;10.576085604081124;23.1520922074668;18.100949525237382;SA
2020-05-05;Segovia;6066;866;9730;2296;40004;15796;3162;14.276294098252556;23.597122302158276;20.017726006583946;SE
2020-05-07;Segovia;7550;971;10179;2299;40004;17729;3270;12.860927152317881;22.585715689163965;18.444356703705793;SE
2020-05-07;Castilla y León;110060;7295;101679;17942;99999;211739;25237;6.628202798473559;17.645728223133585;11.91891904656204;CyL
2020-05-08;León;19281;1158;16267;2467;24089;35548;3625;6.005912556402676;15.165672834573062;10.197479464386182;LE
2020-05-08;Salamanca;14108;1201;12970;2789;37274;27078;3990;8.51290048199603;21.503469545104085;14.735209395080878;SA
2020-05-08;Zamora;10366;789;4419;563;49275;14785;1352;7.61142195639591;12.740439013351438;9.144403111261413;ZA
2020-05-11;Valladolid;25411;656;36036;4699;47186;61447;5355;2.581559167289756;13.039738039738038;8.714827412241444;VA
2020-05-12;Ávila;11961;766;6705;1606;5019;18666;2372;6.404146810467353;23.95227442207308;12.70759669988214;AV
2020-05-12;Burgos;20833;1006;11274;1843;9059;32107;2849;4.828877262036193;16.347347880078054;8.873454386893824;BU
2020-05-12;León;20650;1279;17483;2504;24089;38133;3783;6.193704600484262;14.322484699422297;9.920541263472584;LE
2020-05-13;Palencia;11841;376;6031;802;34120;17872;1178;3.175407482476142;13.297960537224341;6.591316025067144;PA
2020-05-14;Castilla y León;163929;9980;117371;18276;99999;281300;28256;6.0880015128500755;15.57113767455334;10.044792036971204;CyL
2020-05-15;Soria;14524;1415;4275;1013;42173;18799;2428;9.742495180391076;23.695906432748536;12.915580615990214;SO
2020-05-16;Salamanca;21686;1685;15593;2816;37274;37279;4501;7.7699898552061235;18.05938562175335;12.073821722685695;SA
2020-05-16;Castilla y León;175228;11133;122676;18405;99999;297904;29538;6.353436665373113;15.002934559327008;9.915274719372684;CyL
2020-05-17;Palencia;13070;411;6581;824;34120;19651;1235;3.14460596786534;12.520893481233855;6.284667446949264;PA
2020-05-18;Segovia;13780;1558;12398;2333;40004;26178;3891;11.306240928882438;18.817551217938377;14.863625945450378;SE
2020-05-18;Valladolid;32016;1218;39176;4787;47186;71192;6005;3.804347826086957;12.219215846436594;8.434936509720194;VA
2020-05-18;Zamora;18112;1169;5760;609;49275;23872;1778;6.45428445229682;10.572916666666666;7.448056300268097;ZA
2020-05-19;León;27805;1740;21149;2557;24089;48954;4297;6.257867290055745;12.09040616577616;8.777627977284798;LE
2020-05-20;Segovia;15632;1777;12908;2337;40004;28540;4114;11.36770726714432;18.105051131081503;14.414856341976174;SE
2020-05-20;Valladolid;35812;1491;40601;4805;47186;76413;6296;4.163408913213448;11.83468387478141;8.239435698114194;VA
2020-05-21;Burgos;30931;1620;14068;1891;9059;44999;3511;5.237464032847305;13.441853852715383;7.802395608791307;BU
2020-05-21;León;30357;1885;22360;2566;24089;52717;4451;6.209440985604639;11.475849731663686;8.44319669176926;LE
2020-05-21;Segovia;16329;1860;13183;2340;40004;29512;4200;11.390777144956825;17.75013274671926;14.231499051233396;SE
2020-05-21;Valladolid;37310;1551;41160;4810;47186;78470;6361;4.157062449745377;11.686103012633625;8.106282655792024;VA
2020-05-21;Castilla y León;217851;13390;133734;18550;99999;351585;31940;6.146402816604009;13.870818191335038;9.084574142810416;CyL
2020-05-22;Palencia;17110;542;7345;843;34120;24455;1385;3.167738164815897;11.47719537100068;5.663463504395829;PA
2020-05-23;Segovia;17261;2005;13666;2345;40004;30927;4350;11.615781240947802;17.159373627981854;14.06537976525366;SE
2020-05-23;Soria;16799;1533;5019;1033;42173;21818;2566;9.12554318709447;20.581789201036063;11.760931341094508;SO
2020-05-23;Castilla y León;228084;13900;138812;18631;99999;366896;32531;6.094245979551394;13.42175028095554;8.866545288038028;CyL
2020-05-24;Palencia;17122;544;7597;844;34120;24719;1388;3.1771989253591872;11.109648545478478;5.615113880011327;PA
2020-05-24;Soria;16911;1545;5057;1033;42173;21968;2578;9.136065282951925;20.42713070990706;11.73525127458121;SO
2020-05-25;León;31695;1966;23720;2574;24089;55415;4540;6.2028711153178735;10.85160202360877;8.1927276008301;LE
2020-05-25;Segovia;18433;2128;13916;2346;40004;32349;4474;11.54451255899745;16.858292612819774;13.830412068379239;SE
2020-05-26;León;33129;2027;24239;2578;24089;57368;4605;6.118506444504815;10.635752300012378;8.027123134848695;LE
2020-05-26;Salamanca;29803;2124;18358;2880;37274;48161;5004;7.12679931550515;15.687983440461926;10.390149706193808;SA
2020-05-27;Valladolid;43495;1843;43836;4850;47186;87331;6693;4.2372686515691464;11.06396569030021;7.663945219910456;VA
2020-05-28;Salamanca;31232;2242;19037;2895;37274;50269;5137;7.178534836065574;15.207228029626515;10.219021663450635;SA
2020-05-28;Soria;18905;1649;5479;1048;42173;24384;2697;8.722560169267389;19.127578025187077;11.060531496062993;SO
2020-05-28;Valladolid;44912;1897;44495;4854;47186;89407;6751;4.223815461346633;10.909090909090908;7.5508629078260086;VA
2020-05-28;Castilla y León;258789;15525;149668;18778;99999;408457;34303;5.9990957884608695;12.546436111927733;8.39819124167293;CyL
2020-05-29;Ávila;24900;1359;8885;1652;5019;33785;3011;5.457831325301204;18.593134496342152;8.912239159390262;AV
2020-05-29;Soria;19269;1673;5642;1052;42173;24911;2725;8.682339509055996;18.645870258773485;10.938942635783388;SO
2020-05-30;Ávila;24992;1359;9006;1659;5019;33998;3018;5.437740076824584;18.421052631578945;8.876992764280251;AV
2020-05-30;León;36315;2164;26521;2601;24089;62836;4765;5.958970122538896;9.807322499151617;7.583232541854988;LE
2020-05-30;Palencia;20432;653;8636;864;34120;29068;1517;3.195967110415035;10.00463177396943;5.218797302876014;PA
2020-05-30;Soria;19277;1676;5754;1062;42173;25031;2738;8.694298905431342;18.45672575599583;10.938436338939715;SO
2020-06-01;Segovia;20642;2375;15256;2354;40004;35898;4729;11.505668055420987;15.429994756161511;13.173435846008132;SE
2020-06-01;Soria;19504;1697;5882;1071;42173;25386;2768;8.700779327317473;18.20809248554913;10.903647679823525;SO
2020-06-01;Valladolid;46635;1997;45630;4872;47186;92265;6869;4.282191487080519;10.677186061801446;7.444859914377067;VA
2020-06-02;León;37440;2235;27568;2603;24089;65008;4838;5.969551282051282;9.442106790481718;7.442160964804331;LE
2020-06-02;Castilla y León;272822;16316;160620;18956;99999;433442;35272;5.9804561215737735;11.801768148424854;8.137651635051519;CyL
2020-06-03;Ávila;26089;1427;9663;1670;5019;35752;3097;5.4697382038406985;17.282417468695023;8.662452450212575;AV
2020-06-03;Burgos;40460;2068;19104;1963;9059;59564;4031;5.111220958971824;10.27533500837521;6.7675105768585055;BU
2020-06-03;León;38781;2284;28169;2604;24089;66950;4888;5.889481962816843;9.24420462210231;7.300970873786408;LE
2020-06-03;Zamora;28788;1453;7817;617;49275;36605;2070;5.047241906349869;7.893053601125752;5.654965168692802;ZA
2020-06-04;Palencia;21139;704;9525;873;34120;30664;1577;3.330337291262595;9.165354330708661;5.142838507696322;PA
2020-06-04;Salamanca;34581;2496;20995;2943;37274;55576;5439;7.217836384141581;14.017623243629435;9.786598531740319;SA
2020-06-05;Soria;20716;1748;6376;1086;42173;27092;2834;8.437922378837612;17.03262233375157;10.460652591170826;SO
2020-06-05;Valladolid;50731;2215;48918;4914;47186;99649;7129;4.366166643669551;10.045382067950449;7.15411092936206;VA
2020-06-07;León;40388;2390;30249;2612;24089;70637;5002;5.917599286916906;8.634996198221428;7.081274686071039;LE
2020-06-07;Valladolid;50752;2216;49660;4919;47186;100412;7135;4.366330390920555;9.905356423681031;7.105724415408517;VA
2020-06-08;Soria;21125;1771;6583;1089;42173;27708;2860;8.383431952662722;16.542609752392526;10.321928684856358;SO
2020-06-09;Castilla y León;295944;17542;178307;19138;99999;474251;36680;5.9274727651177255;10.73317368359066;7.734301034684165;CyL
2020-06-10;Zamora;30012;1487;8581;625;49275;38593;2112;4.954684792749567;7.283533387717049;5.472495012048817;ZA
2020-06-10;Castilla y León;299746;17752;181314;19168;99999;481060;36920;5.922347587624188;10.571715366711892;7.6747183303538025;CyL
2020-06-21;Valladolid;59330;2563;56616;4991;47186;115946;7554;4.319905612674869;8.815529179030662;6.515101857761371;VA
2020-06-22;Segovia;24466;2607;18463;2384;40004;42929;4991;10.655603694923567;12.912311108703895;11.626173449183536;SE
2020-06-22;Castilla y León;332300;18896;206088;19386;99999;538388;38282;5.6864279265723745;9.406661232095027;7.110485374859767;CyL
2020-06-23;Ávila;31632;1590;12656;1705;5019;44288;3295;5.026555386949924;13.47187104930468;7.439938583815028;AV
2020-06-23;Soria;24729;1899;7919;1136;42173;32648;3035;7.679242994055563;14.345245611819674;9.296128399901985;SO
2020-06-25;Ávila;31937;1604;12908;1707;5019;44845;3311;5.022387826032502;13.22435698791447;7.383208830415877;AV
2020-06-25;Segovia;24705;2629;18915;2400;40004;43620;5029;10.641570532280916;12.688342585249801;11.529115084823475;SE
2020-06-25;Valladolid;60532;2641;58905;5012;47186;119437;7653;4.362981563470561;8.508615567439097;6.407562145733735;VA
2020-06-26;Segovia;25039;2634;18944;2400;40004;43983;5034;10.519589440472862;12.66891891891892;11.44533115067185;SE
2020-06-27;Palencia;25639;848;13316;925;34120;38955;1773;3.307461289441866;6.946530489636528;4.551405467847516;PA
2020-06-27;Soria;24960;1909;8216;1141;42173;33176;3050;7.64823717948718;13.887536514118793;9.19339281408247;SO
2020-06-27;Castilla y León;340196;19248;217347;19491;99999;557543;38739;5.657914849086997;8.967687614735883;6.948163639396424;CyL
2020-06-28;Ávila;32385;1612;13398;1715;5019;45783;3327;4.977613092481087;12.800417972831765;7.266889456785269;AV
2020-06-28;Burgos;46568;2287;27963;2002;9059;74531;4289;4.911097749527572;7.1594607159460715;5.754652426507091;BU
2020-06-28;Soria;24960;1909;8216;1141;42173;33176;3050;7.64823717948718;13.887536514118793;9.19339281408247;SO
2020-06-29;Valladolid;61503;2689;60764;5031;47186;122267;7720;4.372144448238298;8.279573431637154;6.3140503978996785;VA
2020-07-01;León;49609;2755;39626;2636;24089;89235;5391;5.553427805438529;6.652198051784182;6.041351487644983;LE
2020-07-01;Salamanca;42840;3078;27851;3016;37274;70691;6094;7.184873949579831;10.829054612042656;8.62061648583271;SA
2020-07-01;Valladolid;61888;2715;62139;5038;47186;124027;7753;4.386957083764219;8.107629668967958;6.251058237319293;VA
2020-07-02;Zamora;33251;1561;10821;635;49275;44072;2196;4.6945956512586084;5.868219203400795;4.982755491014703;ZA
2020-07-03;Segovia;25346;2649;20149;2422;40004;45495;5071;10.451353270733055;12.02044766489652;11.146279810968238;SE
2020-07-03;Zamora;33325;1562;10920;635;49275;44245;2197;4.687171792948237;5.815018315018315;4.965532828568199;ZA
2020-07-04;Burgos;46852;2315;29492;2004;9059;76344;4319;4.941091095364126;6.795063067950631;5.657288064549932;BU
2020-07-04;Salamanca;43107;3104;28476;3018;37274;71583;6122;7.200686663418934;10.598398651495996;8.552309905983265;SA
2020-07-08;Ávila;33538;1653;14774;1718;5019;48312;3371;4.928737551434194;11.628536618383647;6.9775625103493955;AV
2020-07-08;Castilla y León;347552;19720;237117;19598;99999;584669;39318;5.673971089218304;8.265118064078072;6.72483063066453;CyL
2020-07-09;Burgos;46982;2318;30922;2009;9059;77904;4327;4.933804435741348;6.496992432572278;5.5542719244197984;BU
2020-07-09;León;50363;2801;40835;2638;24089;91198;5439;5.561622619780395;6.460144483898617;5.963946577775828;LE
2020-07-09;Soria;25931;1939;9317;1164;42173;35248;3103;7.477536539277313;12.493291832134808;8.80333635950976;SO
2020-07-09;Zamora;33523;1565;11597;637;49275;45120;2202;4.668436595770068;5.4927998620332845;4.88031914893617;ZA
2020-07-10;León;50493;2810;42144;2647;24089;92637;5457;5.565127839502505;6.280846621108579;5.890734803588199;LE
2020-07-10;Zamora;33583;1567;11661;638;49275;45244;2205;4.666051275943185;5.47122888260012;4.873574396605075;ZA
2020-07-11;Palencia;26005;877;15226;940;34120;41231;1817;3.3724283791578538;6.173650334953369;4.406878319710897;PA
2020-07-11;Segovia;25565;2667;21118;2434;40004;46683;5101;10.432231566594954;11.525712662183919;10.926889874258295;SE
2020-07-12;Burgos;47035;2321;32235;2011;9059;79270;4332;4.9346231529711915;6.2385605708081275;5.464866910558849;BU
2020-07-12;Castilla y León;349409;19818;245085;19639;99999;594494;39457;5.671863060195931;8.013138298957506;6.637072872055899;CyL
2020-07-13;Ávila;34353;1671;15370;1725;5019;49723;3396;4.864203999650686;11.223162003903708;6.829837298634435;AV
2020-07-14;Burgos;47077;2323;33177;2011;9059;80254;4334;4.934469061325063;6.061428097778582;5.400353876442296;BU
2020-07-14;León;50672;2817;43237;2649;24089;93909;5466;5.559283233343859;6.126697041885422;5.820528383860972;LE
2020-07-14;Castilla y León;350443;19892;249691;19679;99999;600134;39571;5.676244068222221;7.881341337893637;6.593694074989918;CyL
2020-07-15;Burgos;47103;2324;33696;2012;9059;80799;4336;4.9338683311041756;5.971035137701804;5.366403049542693;BU
2020-07-15;Salamanca;43785;3173;30965;3025;37274;74750;6198;7.2467740093639375;9.769094138543517;8.291638795986621;SA
2020-07-15;Segovia;25684;2679;21706;2438;40004;47390;5117;10.430618283756424;11.231917442181885;10.797636632200886;SE
2020-07-16;Burgos;47115;2326;34139;2012;9059;81254;4338;4.93685662740104;5.893552828143765;5.338814089152534;BU
2020-07-16;León;50786;2820;43880;2654;24089;94666;5474;5.552711377151184;6.048313582497721;5.782435087571039;LE
2020-07-16;Salamanca;43899;3186;31153;3025;37274;75052;6211;7.257568509533247;9.710140275414886;8.27559558705964;SA
2020-07-16;Soria;26365;1963;10027;1192;42173;36392;3155;7.445476958088375;11.887902662810411;8.669487799516377;SO
2020-07-16;Castilla y León;351579;19957;254071;19713;99999;605650;39670;5.676391365809676;7.758854808301617;6.549987616610253;CyL
2020-07-17;Valladolid;63257;2850;69671;5084;47186;132928;7934;4.505430229065558;7.297153765555253;5.968644679826673;VA
2020-07-17;Castilla y León;352309;19994;256078;19740;99999;608387;39734;5.675131773528352;7.708588789353243;6.53104027535105;CyL
2020-07-18;Burgos;47164;2328;34971;2030;9059;82135;4358;4.9359681112713085;5.804809699465271;5.30589882510501;BU
2020-07-18;Segovia;25775;2689;22056;2442;40004;47831;5131;10.43258971871969;11.071817192600653;10.727352553783112;SE
2020-07-19;Palencia;26110;883;16118;950;34120;42228;1833;3.381846036001532;5.89403151755801;4.340721795964763;PA
2020-07-19;Segovia;25795;2689;22124;2443;40004;47919;5132;10.424500872262065;11.042306996926415;10.709739351822869;SE
2020-07-20;Burgos;47213;2332;35529;2042;9059;82742;4374;4.939317560841293;5.7474176025218835;5.286311667593242;BU
2020-07-20;León;50902;2828;44879;2663;24089;95781;5491;5.555773839927705;5.933732926312975;5.732869775842808;LE
2020-07-20;Salamanca;44078;3199;31695;3027;37274;75773;6226;7.257588819819411;9.550402271651679;8.216647090652343;SA
2020-07-20;Segovia;25831;2692;22326;2444;40004;48157;5136;10.421586465874338;10.946878079369345;10.66511618248645;SE
2020-07-20;Zamora;33738;1571;12561;638;49275;46299;2209;4.656470448752149;5.079213438420508;4.771161364176332;ZA
2020-07-21;Ávila;35375;1695;16429;1727;5019;51804;3422;4.791519434628976;10.511899689573315;6.60566751602193;AV
2020-07-21;Burgos;47229;2333;36105;2044;9059;83334;4377;4.939761587160431;5.661265752665836;5.252357981136151;BU
2020-07-21;León;50960;2831;45302;2668;24089;96262;5499;5.555337519623234;5.889364707959913;5.712534541148116;LE
2020-07-21;Zamora;33779;1571;12731;638;49275;46510;2209;4.650818555907517;5.0113895216400905;4.7495162330681575;ZA
2020-07-21;Castilla y León;353830;20056;263311;19820;99999;617141;39876;5.668258768335076;7.527220663018255;6.461408332941742;CyL
2020-07-22;León;51035;2838;45635;2671;24089;96670;5509;5.560889585578525;5.8529637339761145;5.698769007965242;LE
2020-07-22;Salamanca;44309;3212;32330;3035;37274;76639;6247;7.24909160667133;9.38756572842561;8.15120239042785;SA
2020-07-23;Castilla y León;354865;20118;268533;19872;99999;623398;39990;5.669198145773745;7.400207795689916;6.414842524358436;CyL
2020-07-24;Palencia;26200;889;16763;954;34120;42963;1843;3.393129770992366;5.691105410726004;4.28973768126062;PA
2020-07-24;Salamanca;44449;3224;32880;3040;37274;77329;6264;7.253256541204527;9.245742092457421;8.100453904744663;SA
2020-07-24;Zamora;33875;1572;13172;639;49275;47047;2211;4.640590405904059;4.851199514120863;4.6995557633855505;ZA
2020-07-24;Castilla y León;355366;20147;270560;19911;99999;625926;40058;5.669366230871834;7.3591809580130105;6.399798059195495;CyL
2020-07-25;Burgos;47314;2337;38494;2062;9059;85808;4399;4.9393414211438476;5.356678962955265;5.126561625955621;BU
2020-07-25;Palencia;26200;889;16824;955;34120;43024;1844;3.393129770992366;5.676414645744175;4.285979918185199;PA
2020-07-25;Segovia;25968;2706;23010;2452;40004;48978;5158;10.420517560073938;10.656236418948284;10.531258932581975;SE
2020-07-25;Soria;27113;1998;11159;1229;42173;38272;3227;7.369158706155719;11.013531678465812;8.431751672240804;SO
2020-07-26;Ávila;35851;1703;17096;1728;5019;52947;3431;4.750216172491702;10.107627515208236;6.480064970631008;AV
2020-07-26;Burgos;47318;2337;38849;2068;9059;86167;4405;4.938923876748806;5.323174341681897;5.112165910383325;BU
2020-07-26;Salamanca;44455;3224;33218;3048;37274;77673;6272;7.2522775840737825;9.175748088385816;8.074878014239182;SA
2020-07-26;Segovia;25986;2706;23088;2452;40004;49074;5158;10.413299468944816;10.62023562023562;10.51065737457717;SE
2020-07-26;Soria;27167;1998;11215;1233;42173;38382;3231;7.354510987595245;10.994204190815871;8.418008441456932;SO
2020-07-26;Castilla y León;355658;20157;273731;19943;99999;629389;40100;5.667523294850671;7.285619823841655;6.37125847448875;CyL
2020-07-27;Palencia;26208;889;17034;955;34120;43242;1844;3.392094017094017;5.606434190442644;4.264372600712271;PA
2020-07-27;Segovia;26004;2706;23262;2454;40004;49266;5160;10.406091370558377;10.549393861232913;10.473754719279016;SE
2020-07-28;León;51251;2849;47656;2680;24089;98907;5529;5.5589159235917345;5.623636058418667;5.590099790712488;LE
2020-07-29;León;51318;2852;48049;2680;24089;99367;5532;5.557504189563116;5.577639493017545;5.567240633208208;LE
2020-07-29;Palencia;26264;895;17311;960;34120;43575;1855;3.4077063661285414;5.545606839581769;4.257028112449799;PA
2020-07-29;Salamanca;44582;3231;34075;3062;37274;78657;6293;7.247319546005114;8.986060161408657;8.000559390772596;SA
2020-07-29;Segovia;26044;2711;23585;2465;40004;49629;5176;10.409307326063583;10.451558193767225;10.429386044449817;SE
2020-07-29;Soria;27375;2011;11536;1245;42173;38911;3256;7.3461187214611865;10.792302357836338;8.367813728765643;SO
2020-07-29;Castilla y León;357068;20233;280966;20053;99999;638034;40286;5.666427683242407;7.1371625036481285;6.314083575483438;CyL
2020-07-30;Ávila;36407;1714;17664;1732;5019;54071;3446;4.707885846128492;9.805253623188406;6.373102032512808;AV
2020-07-30;Salamanca;44631;3234;34458;3068;37274;79089;6302;7.246084560059152;8.903592779615764;7.968238313798379;SA
2020-07-30;Zamora;33978;1575;13820;643;49275;47798;2218;4.635352286773794;4.652677279305355;4.640361521402569;ZA
2020-07-31;León;51417;2858;48806;2684;24089;100223;5542;5.558472878619912;5.499323853624554;5.529668838490167;LE
2020-07-31;Palencia;26293;896;17633;971;34120;43926;1867;3.4077511124633935;5.506720353881926;4.250330100623776;PA
2020-07-31;Soria;27448;2022;11882;1280;42173;39330;3302;7.366656951326143;10.772597205857599;8.395626748029494;SO
2020-07-31;Castilla y León;357922;20283;286986;20263;99999;644908;40546;5.666877140829566;7.060623166286857;6.287098314798389;CyL
2020-08-01;Burgos;47470;2349;43012;2205;9059;90482;4554;4.948388455866863;5.126476332186367;5.033045246568378;BU
2020-08-01;Salamanca;44684;3236;34931;3090;37274;79615;6326;7.241965804314744;8.846010706822021;7.945738868303712;SA
2020-08-01;Segovia;26098;2717;24104;2477;40004;50202;5194;10.410759445168212;10.276302688350482;10.346201346559898;SE
2020-08-01;Valladolid;63998;2916;76477;5252;47186;140475;8168;4.556392387262101;6.867424192894596;5.814557750489411;VA
2020-08-02;León;51418;2858;49262;2689;24089;100680;5547;5.5583647749815235;5.458568470626447;5.50953516090584;LE
2020-08-02;Palencia;26294;896;17754;971;34120;44048;1867;3.407621510610786;5.469190041680748;4.238557936796222;PA
2020-08-02;Soria;27557;2028;12202;1321;42173;39759;3349;7.359291650034475;10.826094082937225;8.423250081742498;SO
2020-08-02;Valladolid;64001;2918;76693;5254;47186;140694;8172;4.559303760878737;6.850690415031359;5.80835003624888;VA
2020-08-03;León;51461;2860;49582;2689;24089;101043;5549;5.55760673131109;5.423339115001411;5.491721346357491;LE
2020-08-03;Salamanca;44728;3237;35537;3120;37274;80265;6357;7.2370774458951885;8.779581844274981;7.9200149504765465;SA
2020-08-03;Soria;27667;2035;12295;1330;42173;39962;3365;7.355333068276286;10.817405449369662;8.420499474500776;SO
2020-08-03;Zamora;34057;1578;14330;667;49275;48387;2245;4.633408697184133;4.654570830425681;4.639675946018559;ZA
2020-08-04;Salamanca;44777;3243;35978;3145;37274;80755;6388;7.242557563034594;8.741453110234032;7.910346108600088;SA
2020-08-04;Zamora;34086;1580;14639;670;49275;48725;2250;4.635334154784956;4.57681535624018;4.617752693689072;ZA
2020-08-04;Castilla y León;359289;20360;297177;20656;99999;656466;41016;5.666747381634283;6.950739794802424;6.248000658069115;CyL
2020-08-05;Ávila;37038;1723;18658;1736;5019;55696;3459;4.651979048544738;9.30431986279344;6.210499856363114;AV
2020-08-05;Segovia;26144;2717;24844;2490;40004;50988;5207;10.392441860465116;10.022540653678956;10.212206793755394;SE
2020-08-05;Valladolid;64267;2956;78592;5329;47186;142859;8285;4.599561205595407;6.7805883550488595;5.799424607480103;VA
2020-08-05;Castilla y León;359878;20413;301384;20894;99999;661262;41307;5.672200023341244;6.932683885010485;6.246691931488578;CyL
2020-08-06;Burgos;47654;2355;47909;2532;9059;95563;4887;4.941872665463549;5.285019516166065;5.113903916787878;BU
2020-08-06;León;51713;2866;50864;2710;24089;102577;5576;5.542126737957574;5.327933312362378;5.435916433508487;LE
2020-08-06;Zamora;34148;1582;15032;674;49275;49180;2256;4.632774979500995;4.483767961681746;4.58723058153721;ZA
2020-08-06;Castilla y León;360643;20458;305267;21076;99999;665910;41534;5.672645802081282;6.904119999868967;6.237179198390173;CyL
2020-08-07;Burgos;47691;2358;49155;2615;9059;96846;4973;4.944329118701642;5.31990641847218;5.134956528922206;BU
2020-08-07;Palencia;26601;906;18701;998;34120;45302;1904;3.4058869967294467;5.336613015346773;4.202904949008874;PA
2020-08-08;Burgos;47693;2358;50668;2705;9059;98361;5063;4.9441217788774035;5.338675298018473;5.147365317554722;BU
2020-08-08;Salamanca;44916;3258;37710;3270;37274;82626;6528;7.253539941223617;8.671439936356403;7.900660808946336;SA
2020-08-08;Castilla y León;361449;20513;312894;21495;99999;674343;42008;5.675212823939201;6.869738633530845;6.229470758946115;CyL
2020-08-09;Ávila;37491;1745;19474;1762;5019;56965;3507;4.654450401429677;9.047961384409984;6.15641183182656;AV
2020-08-09;Castilla y León;361578;20516;315718;21723;99999;677296;42239;5.674017777630276;6.880507288149551;6.236416574141882;CyL
2020-08-10;Ávila;37771;1751;19573;1764;5019;57344;3515;4.635831722750258;9.012415061564399;6.129673549107143;AV
2020-08-10;Segovia;26174;2721;25836;2535;40004;52010;5256;10.395812638496217;9.811890385508592;10.105748894443376;SE
2020-08-10;Soria;28226;2103;13512;1413;42173;41738;3516;7.4505774817544115;10.457371225577266;8.423978149408214;SO
2020-08-10;Castilla y León;362533;20541;318869;21901;99999;681402;42442;5.665966960249136;6.868337781345944;6.228628621577277;CyL
2020-08-11;Palencia;26785;915;19364;1013;34120;46149;1928;3.4160910957625537;5.231357157612063;4.177771999393269;PA
2020-08-11;Segovia;26187;2721;26112;2555;40004;52299;5276;10.390651850154658;9.784773284313726;10.088147000898678;SE
2020-08-11;Soria;28300;2103;13781;1427;42173;42081;3530;7.431095406360424;10.354836368913723;8.388583921484756;SO
2020-08-13;Soria;28633;2122;14269;1473;42173;42902;3595;7.411029232005029;10.323078001261477;8.379562724348515;SO
2020-08-13;Valladolid;65677;3010;83939;5670;47186;149616;8680;4.583035156904244;6.754905347931235;5.80151855416533;VA
2020-08-13;Zamora;34330;1590;16320;721;49275;50650;2311;4.631517623070201;4.417892156862745;4.562685093780849;ZA
2020-08-14;León;52455;2884;55171;2802;24089;107626;5686;5.498045944142598;5.078755143100542;5.2831100291751065;LE
2020-08-14;Palencia;27454;931;20248;1055;34120;47702;1986;3.3911269760326364;5.2103911497431845;4.163347448744288;PA
2020-08-15;Burgos;48822;2382;61558;3296;9059;110380;5678;4.878948015239032;5.354300009746906;5.144047834752673;BU
2020-08-15;León;52511;2887;55670;2824;24089;108181;5711;5.497895679000591;5.0727501347224715;5.279115556336141;LE
2020-08-15;Palencia;27458;931;20434;1065;34120;47892;1996;3.390632966712798;5.211901732406773;4.167710682368663;PA
2020-08-15;Valladolid;66267;3029;86557;5848;47186;152824;8877;4.57090256085231;6.75624155180979;5.8086426215777625;VA
2020-08-16;Segovia;26378;2737;27399;2657;40004;53777;5394;10.376070968231103;9.69743421292748;10.030310355728284;SE
2020-08-17;Castilla y León;371903;20632;352429;23788;99999;724332;44420;5.547683132429693;6.7497283140717705;6.1325469536069095;CyL
2020-08-18;León;52663;2892;56848;2847;24089;109511;5739;5.491521561627708;5.008091753447791;5.240569440512825;LE
2020-08-19;Soria;30072;2197;15564;1573;42173;45636;3770;7.305799414737963;10.106656386533025;8.2610220001753;SO
2020-08-20;Palencia;27731;959;22145;1146;34120;49876;2105;3.4582236486242834;5.174983066154888;4.220466757558746;PA
2020-08-20;Salamanca;47405;3404;44188;3740;37274;91593;7144;7.180677143761207;8.46383633565674;7.799722686231481;SA
2020-08-20;Valladolid;67811;2846;90837;6217;47186;158648;9063;4.1969591954107734;6.844127393022667;5.712646866017851;VA
2020-08-20;Zamora;34722;1623;18220;831;49275;52942;2454;4.674269915327458;4.5609220636663;4.635261229269767;ZA
2020-08-23;Salamanca;48590;3431;45797;3863;37274;94387;7294;7.061123688001647;8.435050330807695;7.727759119370252;SA
2020-08-23;Segovia;26454;2748;29884;2874;40004;56338;5622;10.387843048310275;9.617186454289921;9.979054989527494;SE
2020-08-24;Palencia;28730;1000;23605;1239;34120;52335;2239;3.4806822137138878;5.248887947468757;4.278207700391707;PA
2020-08-24;Soria;31287;2222;16486;1664;42173;47773;3886;7.101991242369035;10.093412592502728;8.13430180227325;SO
2020-08-25;Palencia;29060;1009;23916;1239;34120;52976;2248;3.4721266345492086;5.180632212744606;4.243430987617034;PA
2020-08-25;Salamanca;49893;3475;47177;4003;37274;97070;7478;6.964904896478464;8.485066875808126;7.7037189656948595;SA
2020-08-25;Soria;31358;2231;16803;1670;42173;48161;3901;7.114611901269213;9.938701422365053;8.099914868877308;SO
2020-06-23;Segovia;24565;2617;18704;2393;40004;43269;5010;10.65336861388154;12.794054747647563;11.578728419884907;SE
2020-06-23;Zamora;32663;1545;9874;632;49275;42537;2177;4.730122768882222;6.400648166902978;5.117897359945459;ZA
2020-06-24;León;48440;2706;37420;2631;24089;85860;5337;5.586292320396367;7.030999465526457;6.215932914046122;LE
2020-06-24;Segovia;24631;2625;18874;2400;40004;43505;5025;10.657301774187001;12.715905478435943;11.550396506148719;SE
2020-06-27;Zamora;33079;1556;10373;635;49275;43452;2191;4.703890685933674;6.121662007133906;5.042345576728343;ZA
2020-06-28;Segovia;25088;2635;18972;2400;40004;44060;5035;10.503029336734695;12.65022137887413;11.4275987290059;SE
2020-06-28;Castilla y León;340137;19249;218291;19499;99999;558428;38748;5.659190267451057;8.932571658932343;6.938763815567987;CyL
2020-06-29;Burgos;46585;2287;28114;2002;9059;74699;4289;4.909305570462595;7.121007327310237;5.741710063053053;BU
2020-06-29;Soria;24964;1909;8216;1141;42173;33180;3050;7.647011696843455;13.887536514118793;9.192284508740205;SO
2020-06-30;León;49341;2747;39328;2636;24089;88669;5383;5.567378042601487;6.702603742880391;6.070892871240231;LE
2020-06-30;Palencia;25746;858;13795;933;34120;39541;1791;3.3325565136331856;6.76332004349402;4.529475734048203;PA
2020-07-01;Ávila;32852;1633;13867;1716;5019;46719;3349;4.970778034822842;12.374702531189154;7.168389734369314;AV
2020-07-01;Burgos;46756;2305;28660;2004;9059;75416;4309;4.929848575583883;6.992323796231682;5.713641667550652;BU
2020-07-01;Palencia;25799;862;13954;933;34120;39753;1795;3.3412147757665025;6.686254837322632;4.515382486856337;PA
2020-07-01;Soria;25267;1921;8588;1149;42173;33855;3070;7.602802073851269;13.379133674895202;9.068084477920543;SO
2020-07-02;Palencia;25827;864;14090;934;34120;39917;1798;3.3453362759902427;6.628814762242725;4.504346519026981;PA
2020-07-03;León;49981;2778;40037;2636;24089;90018;5414;5.558112082591385;6.583909883357894;6.014352685018552;LE
2020-07-03;Soria;25380;1926;8780;1152;42173;34160;3078;7.588652482269503;13.120728929384967;9.010538641686184;SO
2020-07-03;Castilla y León;345120;19583;229201;19563;99999;574321;39146;5.67425822902179;8.535303074593916;6.816048864659311;CyL
2020-07-05;Ávila;33171;1640;14391;1718;5019;47562;3358;4.944077658195411;11.938016816065597;7.060258189310795;AV
2020-07-05;León;49987;2778;40221;2637;24089;90208;5415;5.557444935683278;6.556276571940031;6.002793543809862;LE
2020-07-05;Salamanca;43112;3104;28617;3018;37274;71729;6122;7.199851549452589;10.546178844742636;8.53490220134116;SA
2020-07-05;Segovia;25382;2651;20280;2426;40004;45662;5077;10.444409424001261;11.962524654832347;11.118654461039815;SE
2020-07-05;Valladolid;62186;2745;63780;5044;47186;125966;7789;4.4141768243656125;7.908435246158671;6.1834145721861455;VA
2020-07-08;Burgos;46960;2316;30466;2009;9059;77426;4325;4.931856899488927;6.594236197728616;5.585978870146979;BU
2020-08-12;Ávila;38717;1772;20152;1790;5019;58869;3562;4.5768008884985925;8.882493052798731;6.050722791282339;AV
2020-08-12;León;52154;2877;53867;2776;24089;106021;5653;5.516355408981095;5.153433456476136;5.331962535724054;LE
2020-08-12;Valladolid;65304;3000;83052;5594;47186;148356;8594;4.593899301727307;6.7355391802726;5.792822669794279;VA
2020-08-12;Zamora;34283;1585;16110;721;49275;50393;2306;4.623282676545227;4.475481067659839;4.57603238545036;ZA
2020-08-13;Ávila;39393;1785;20411;1802;5019;59804;3587;4.531261899322215;8.828572828376856;5.997926560096315;AV
2020-08-13;León;52241;2881;54562;2790;24089;106803;5671;5.514825520185295;5.1134489204941165;5.309775942623335;LE
2020-08-13;Segovia;26303;2725;26681;2602;40004;52984;5327;10.360034976998822;9.752258161238334;10.053978559565152;SE
2020-08-14;Segovia;26354;2735;27009;2629;40004;53363;5364;10.377931243833952;9.733792439557185;10.051908625826885;SE
2020-08-14;Valladolid;66040;3029;85652;5774;47186;151692;8803;4.586614173228346;6.741231961892308;5.803206497376263;VA
2020-08-15;Zamora;34392;1594;16724;755;49275;51116;2349;4.634798790416376;4.5144702224348245;4.595430002347602;ZA
2020-08-16;León;52547;2887;55869;2831;24089;108416;5718;5.494129065408111;5.067210796685102;5.274129279811098;LE
2020-08-18;Salamanca;46043;3331;42847;3636;37274;88890;6967;7.234541624133961;8.486008355310757;7.837777027787153;SA
2020-08-19;Salamanca;46462;3354;43420;3674;37274;89882;7028;7.218802462227196;8.461538461538462;7.819140651075855;SA
2020-08-21;León;53205;2924;58985;2946;24089;112190;5870;5.495724086082135;4.994490124607951;5.232195382832694;LE
2020-08-22;Segovia;26454;2748;29780;2873;40004;56234;5621;10.387843048310275;9.647414372061787;9.995732119358395;SE
2020-08-22;Castilla y León;382319;21052;380821;25730;99999;763140;46782;5.506396490888498;6.756455132463808;6.130198915009041;CyL
2020-08-23;Soria;30441;2215;16361;1654;42173;46802;3869;7.276370684274498;10.109406515494163;8.266740737575319;SO
2020-08-23;Zamora;34866;1627;18901;865;49275;53767;2492;4.666437216772787;4.576477435056346;4.634813175367791;ZA
2020-08-23;Castilla y León;382523;21053;385156;25948;99999;767679;47001;5.50372134486031;6.7370104581000945;6.122480880680596;CyL
2020-08-24;Zamora;34989;1635;19058;882;49275;54047;2517;4.672897196261682;4.6279777521250915;4.657057746035858;ZA
2020-08-24;Castilla y León;385224;21127;390348;26290;99999;775572;47417;5.484341577887151;6.735015934499472;6.113810194282413;CyL
2020-05-02;León;15584;944;14284;2412;24089;29868;3356;6.057494866529774;16.886026323158777;11.23610553100308;LE
2020-05-03;Segovia;4532;732;9282;2290;40004;13814;3022;16.15180935569285;24.671407024348202;21.876357318662226;SE
2020-05-03;Soria;8012;921;3062;981;42173;11074;1902;11.495257114328506;32.03788373612018;17.17536572150984;SO
2020-05-04;Salamanca;7040;798;11594;2765;37274;18634;3563;11.335227272727273;23.848542349491115;19.120961682945154;SA
2020-05-04;Castilla y León;81467;5731;93843;17741;99999;175310;23472;7.034750266979267;18.904979593576503;13.388854030003994;CyL
2020-05-05;Palencia;6624;257;4678;771;34120;11302;1028;3.879830917874396;16.481402308678923;9.095735268094142;PA
2020-05-05;Castilla y León;88739;6115;96301;17794;99999;185040;23909;6.890994940217943;18.477482061453152;12.920990056204065;CyL
2020-05-06;Segovia;6670;899;9901;2298;40004;16571;3197;13.478260869565217;23.20977679022321;19.292740329491277;SE
2020-05-07;Burgos;16480;844;10108;1824;9059;26588;2668;5.1213592233009715;18.045112781954884;10.034602076124568;BU
2020-05-07;Zamora;9390;737;4352;563;49275;13742;1300;7.84877529286475;12.93658088235294;9.460049483335759;ZA
2020-05-08;Burgos;17572;886;10378;1835;9059;27950;2721;5.04211245162759;17.681634226247834;9.735241502683364;BU
2020-05-09;Castilla y León;123309;7898;106539;18105;99999;229848;26003;6.40504748234111;16.993776926759217;11.313128676342627;CyL
2020-05-10;Castilla y León;124191;7978;107583;18122;99999;231774;26100;6.423975972493981;16.84466876737031;11.260969737761785;CyL
2020-05-11;Soria;12232;1267;3763;999;42173;15995;2266;10.358077174623938;26.547967047568427;14.166927164738983;SO
2020-05-12;Castilla y León;144586;8931;111822;18166;99999;256408;27097;6.176946592339507;16.245461537085724;10.56792299772238;CyL
2020-05-14;Ávila;13398;798;6946;1610;5019;20344;2408;5.956112852664576;23.178807947019866;11.83641368462446;AV
2020-05-14;Valladolid;29296;822;37582;4737;47186;66878;5559;2.8058438012015294;12.604438294928425;8.312150482968988;VA
2020-05-15;Burgos;25671;1315;12096;1860;9059;37767;3175;5.122511783724826;15.376984126984128;8.406810178197897;BU
2020-05-15;Zamora;16250;1130;5520;606;49275;21770;1736;6.953846153846153;10.978260869565219;7.974276527331189;ZA
2020-05-17;León;25771;1618;20278;2551;24089;46049;4169;6.278374917542974;12.580136108097445;9.05339963951443;LE
2020-05-17;Zamora;16642;1140;5695;609;49275;22337;1749;6.8501382045427235;10.693590869183495;7.830057751712404;ZA
2020-05-18;Ávila;15126;936;7351;1624;5019;22477;2560;6.1880206267354225;22.092232349340225;11.389420296302887;AV
2020-05-19;Castilla y León;197923;12332;127726;18477;99999;325649;30809;6.230705880569717;14.466122794106134;9.460799818209175;CyL
2020-05-22;Soria;16604;1517;4875;1029;42173;21479;2546;9.136352686099734;21.107692307692307;11.853438242003818;SO
2020-05-22;Valladolid;38727;1607;41670;4821;47186;80397;6428;4.149559738683606;11.569474442044637;7.995323208577434;VA
2020-05-22;Zamora;25093;1340;6406;612;49275;31499;1952;5.340134698920018;9.55354355291914;6.197022127686593;ZA
2020-05-22;Castilla y León;226948;13802;136524;18596;99999;363472;32398;6.0815693462819675;13.62104831384958;8.913478892459391;CyL
2020-05-23;Palencia;17114;542;7556;844;34120;24670;1386;3.1669977795956523;11.169931180518793;5.618159708147548;PA
2020-05-23;Salamanca;28057;2008;17746;2861;37274;45803;4869;7.15685925081085;16.12194297306435;10.63030805842412;SA
2020-05-24;Ávila;21527;1233;8190;1632;5019;29717;2865;5.727690806893668;19.926739926739927;9.64094625971666;AV
2020-05-24;Segovia;17433;2032;13720;2346;40004;31153;4378;11.656054609074744;17.099125364431487;14.053221198600454;SE
2020-05-25;Soria;17241;1560;5098;1034;42173;22339;2594;9.048199060379329;20.282463711259318;11.611979050091769;SO
2020-05-26;Ávila;22737;1289;8458;1637;5019;31195;2926;5.669173593701895;19.354457318515013;9.379708286584389;AV
2020-05-26;Castilla y León;244382;14831;144091;18715;99999;388473;33546;6.068777569542765;12.988319881186195;8.635349174846128;CyL
2020-05-27;Soria;18545;1628;5365;1039;42173;23910;2667;8.7786465354543;19.366262814538675;11.154328732747805;SO
2020-05-28;Burgos;37499;1918;16523;1925;9059;54022;3843;5.114803061414971;11.65042667796405;7.113768464699567;BU
2020-05-28;León;34897;2119;25280;2585;24089;60177;4704;6.072155199587357;10.225474683544304;7.816940026920584;LE
2020-05-28;Palencia;19988;633;8219;854;34120;28207;1487;3.16690014008405;10.390558462100012;5.2717410571843875;PA
2020-05-28;Zamora;26994;1414;7244;613;49275;34238;2027;5.238201081721864;8.462175593594699;5.920322448741165;ZA
2020-06-01;León;36792;2201;26855;2602;24089;63647;4803;5.982278756251358;9.689070936510893;7.546310116737631;LE
2020-06-01;Palencia;20619;671;8803;867;34120;29422;1538;3.2542800329792914;9.848915142565035;5.227380871456734;PA
2020-06-03;Palencia;21011;699;9328;870;34120;30339;1569;3.32682880395983;9.326758147512864;5.171561356669633;PA
2020-06-03;Castilla y León;278601;16654;164162;18991;99999;442763;35645;5.977724415920976;11.568450676770507;8.050582365735167;CyL
2020-06-05;Ávila;26854;1457;9860;1672;5019;36714;3129;5.425634914724063;16.95740365111562;8.522634417388462;AV
2020-06-07;Ávila;27160;1463;10281;1682;5019;37441;3145;5.38659793814433;16.36027623772007;8.39988248177132;AV
2020-06-07;Palencia;21634;721;9984;882;34120;31618;1603;3.3327170195063323;8.834134615384617;5.069896894174204;PA
2020-06-08;Burgos;41621;2141;21185;1978;9059;62806;4119;5.1440378655005885;9.33679490205334;6.558290609177467;BU
2020-06-09;Burgos;42115;2156;21633;1981;9059;63748;4137;5.11931615813843;9.15730596773448;6.489615360481897;BU
2020-06-09;Valladolid;52431;2277;50499;4922;47186;102930;7199;4.342850603650512;9.746727657973425;6.994073642281162;VA
2020-06-10;Soria;21927;1808;6777;1098;42173;28704;2906;8.245542025812924;16.201859229747676;10.12402452619844;SO
2020-06-11;Castilla y León;304086;17923;184310;19202;99999;488396;37125;5.8940562867083655;10.418316965981226;7.601413606991048;CyL
2020-06-15;Ávila;29361;1536;11375;1689;5019;40736;3225;5.231429447225912;14.848351648351649;7.9168303220738405;AV
2020-06-15;Soria;22840;1847;7231;1115;42173;30071;2962;8.086690017513135;15.419720647213387;9.85002161550996;SO
2020-06-15;Castilla y León;313033;18220;191596;19252;99999;504629;37472;5.820472601930148;10.048226476544396;7.425653301732559;CyL
2020-06-16;León;46219;2613;34690;2627;24089;80909;5240;5.653519115515264;7.572787546843471;6.4764117712491815;LE
2020-06-16;Salamanca;38469;2774;24050;2986;37274;62519;5760;7.211001065793236;12.415800415800415;9.213199187447016;SA
2020-06-16;Segovia;23381;2566;17593;2377;40004;40974;4943;10.974723065737138;13.511055533450806;12.063747742470834;SE
2020-06-17;Palencia;24567;810;11750;909;34120;36317;1719;3.2971058737330563;7.736170212765956;4.733320483520115;PA
2020-06-18;León;47189;2648;35612;2630;24089;82801;5278;5.611477251054271;7.385151072672133;6.374319150734895;LE
2020-06-18;Salamanca;39458;2847;24676;2992;37274;64134;5839;7.215266866034771;12.125141838223374;9.10437521439486;SA
2020-06-18;Segovia;24165;2588;18005;2382;40004;42170;4970;10.709704117525346;13.229658428214385;11.78562959449846;SE
2020-06-19;Segovia;24303;2598;18176;2382;40004;42479;4980;10.690038266880633;13.105193661971832;11.7234398173215;SE
2020-06-21;Zamora;32463;1536;9681;629;49275;42144;2165;4.731540523057019;6.49726267947526;5.137148823082764;ZA
2020-06-22;León;48087;2675;36608;2630;24089;84695;5305;5.5628340299873145;7.1842220279720275;6.263651927504575;LE
2020-06-22;Valladolid;59704;2587;56965;4997;47186;116669;7584;4.333043012193488;8.772053015009217;6.500441419743034;VA
2020-05-02;Burgos;12517;720;9099;1784;9059;21616;2504;5.752177039226652;19.60655017034839;11.5840118430792;BU
2020-05-03;Ávila;6576;468;5634;1591;5019;12210;2059;7.116788321167883;28.239261625843092;16.863226863226863;AV
2020-05-04;Palencia;6295;250;4616;770;34120;10911;1020;3.971405877680699;16.68110918544194;9.348364036293647;PA
2020-05-06;Palencia;6917;269;4871;776;34120;11788;1045;3.8889692063033108;15.931020324368713;8.864947404139803;PA
2020-05-08;Soria;11004;1185;3484;991;42173;14488;2176;10.768811341330425;28.444316877152698;15.019326339039205;SO
2020-05-08;Castilla y León;120655;7789;104116;18009;99999;224771;25798;6.455596535576643;17.29705328671866;11.477459280779104;CyL
2020-05-09;Burgos;17787;890;10568;1837;9059;28355;2727;5.003654354303705;17.382664647993945;9.617351437136309;BU
2020-05-10;Soria;11702;1221;3727;999;42173;15429;2220;10.434113826696292;26.804400321974782;14.388489208633093;SO
2020-05-12;Palencia;11102;360;5821;797;34120;16923;1157;3.2426589803638985;13.691805531695586;6.836849258405719;PA
2020-05-12;Soria;13165;1296;3860;1001;42173;17025;2297;9.84428408659324;25.932642487046632;13.491923641703377;SO
2020-05-13;Burgos;22516;1110;11512;1848;9059;34028;2958;4.9298276780955765;16.052814454482277;8.692841189608558;BU
2020-05-13;Salamanca;17764;1469;14152;2803;37274;31916;4272;8.269533888763792;19.806387789711703;13.385135981952626;SA
2020-05-13;Castilla y León;153972;9449;114195;18211;99999;268167;27660;6.136830073000286;15.94728315600508;10.31446822315945;CyL
2020-05-15;Salamanca;21528;1663;15382;2813;37274;36910;4476;7.724823485693051;18.287608893511898;12.126794906529396;SA
2020-05-16;Segovia;12730;1467;12169;2329;40004;24899;3796;11.523959151610368;19.138795299531598;15.245592192457528;SE
2020-05-16;Soria;14737;1426;4349;1014;42173;19086;2440;9.676324896518967;23.31570475971488;12.784239756889868;SO
2020-06-03;Salamanca;33949;2460;20629;2932;37274;54578;5392;7.246163362691095;14.213001114935286;9.879438601634357;SA
2020-06-03;Soria;20213;1717;6157;1080;42173;26370;2797;8.494533221194281;17.541010232255967;10.606750094804703;SO
2020-06-06;Ávila;27095;1461;10112;1680;5019;37207;3141;5.392138770990957;16.61392405063291;8.441959846265487;AV
2020-06-06;Burgos;41254;2122;20802;1975;9059;62056;4097;5.143743636980656;9.494279396211901;6.6021013278329255;BU
2020-06-06;León;40383;2390;30174;2612;24089;70557;5002;5.918331971374093;8.656459203287598;7.089303683546635;LE
2020-06-06;Valladolid;50740;2216;49544;4917;47186;100284;7133;4.367363027197477;9.924511545293074;7.11279964899685;VA
2020-06-08;León;40904;2415;30667;2615;24089;71571;5030;5.904068061803247;8.527081227377964;7.02798619552612;LE
2020-06-09;Zamora;29770;1481;8449;623;49275;38219;2104;4.97480685253611;7.373653686826843;5.50511525680944;ZA
2020-06-10;Valladolid;53243;2327;51128;4927;47186;104371;7254;4.370527581090472;9.636598341417619;6.950206474978682;VA
2020-06-11;León;43372;2541;32643;2620;24089;76015;5161;5.858618463524855;8.02622307998652;6.789449450766297;LE
2020-06-11;Palencia;22896;772;10808;892;34120;33704;1664;3.371767994409504;8.253145817912658;4.937099454070734;PA
2020-06-14;Ávila;29063;1523;11280;1688;5019;40343;3211;5.2403399511406255;14.964539007092197;7.959249436085567;AV
2020-06-16;Burgos;44680;2232;24433;1991;9059;69113;4223;4.995523724261415;8.148815127082225;6.110283159463488;BU
2020-06-16;Palencia;23924;798;11511;903;34120;35435;1701;3.335562614947333;7.844670315350534;4.800338648229152;PA
2020-06-16;Castilla y León;317355;18370;194297;19284;99999;511652;37654;5.788470325030329;9.925011708878676;7.359298898470054;CyL
2020-06-17;Ávila;30123;1557;11688;1693;5019;41811;3250;5.168807887660591;14.484941820670775;7.773074071416612;AV
2020-06-17;Zamora;31495;1520;9331;628;49275;40826;2148;4.826162882997301;6.730253992069446;5.26135305932494;ZA
2020-06-18;Castilla y León;326594;18649;199426;19330;99999;526020;37979;5.710147767564622;9.692818388775787;7.220067678035055;CyL
2020-06-19;Zamora;32449;1535;9557;629;49275;42006;2164;4.730500169496748;6.581563252066548;5.151645003094796;ZA
